new_para	doc
ADJ_AAKKOSELLINEN	Back-vowel nen:se variation for adjectives
ADJ_AAVA	Bisyllabic a stems with e comparative and j plurals are in class described here, and dictionary class ⁹.
ADJ_ABNORMAALI	The i stems with trisyllabic allomorph sets have class described here, and dictionary class of ⁶.
ADJ_ABNORMI	The i finals with back vowel harmony go to class described here, where old dictionary classification was ⁵.
ADJ_AHNE	Lengthening e:ee stem for adjectives
ADJ_AIEMPI	lexicalised comparatives
ADJ_AINOA	stem final a : 0 variation with colloquial a:o chance
ADJ_AINUT	defective paradigm for ainut
ADJ_ALASTON	Caritive ton:toma stems
ADJ_AUTIO	The class for o final long vowel stems is described here, and old old dictionaries used ³.
ADJ_AUTUAS	Adjectival as : aa stems
ADJ_AVOIN	Adjectival n : me stems
ADJ_BEIGE	The front variation of unchanging e stems is class described here, and in old dictionaries ⁸.
ADJ_COOL	New consonant-final adjective loan word with 0:i stem
ADJ_EHTA	The ta : da stem with a comparative and j plurals is described here, and the dictionary class is ⁹⁻F. None with k:g gradation.
ADJ_EHYT	Adjectival yt : ye variation stem
ADJ_GAY	Some loan words inflect irregularly, either more along the written form or the pronunciation. There are not many direct adjective loans in general.
ADJ_HAILAKKA	The a : o stem variation combines with trisyllabic class of special illatives
ADJ_HALPA	The pa : va stem with e comparative and j plurals is described here, and the dictionary class is ⁹⁻E.
ADJ_HAPAN	This one word, hapan, also takes the same variation as normative variant. The expected e variant is not normative, but used. Dictionary class 34 0~p back
ADJ_HAPERA	Certain trisyllabic or longer a stems allow a lot of allomorphs and both a : o : 0 variations:
ADJ_HARMAJA	Trisyllabic old stems with archaic aa : ata variationws
ADJ_HARRAS	Adjectival rras : rtaa stems
ADJ_HELLE	Adjectival lle : ltee stems
ADJ_HIDAS	Adjectival das : taa stems
ADJ_HOIKKA	Adjectial a:0 stems with k:0 gradations
ADJ_HUPAKKO	The class for trisyllabic -kko stems is described here, the corresponding dictionary class is ⁴⁻D.
ADJ_HURTTI	Stems with quantitative t gradation, i final and back harmony are in class described here and dictionary class ⁵⁻C.
ADJ_HÄPÄISTY	The stems ending in y are in class described here, and in old dictionaries the class is ¹. Common part of this class is formed by nut participle passive’s _front_ vowel versions after s stem verbs
ADJ_HÖLÖ	The words in this class ending in ö belong to described here, the old dictionaries use class ¹. This class includes front vowel moderative derivations.
ADJ_HÖMPPÄ	The quantitative k and t gradations are not found for adjectives with this a stem.
ADJ_HÖPPÄNÄ	Adjectival ä:ö:0 variations stems
ADJ_IKÄLOPPU	The quantitative gradation of p before u is in class described here and old dictionaries would use ¹⁻B. It is only a nominal compound based adjective that ends in u and has p ~ 0 gradation here:
ADJ_JÄREÄ	Adjectival eä finals with ä:0 variation
ADJ_KADE	Adjectives de:tee variation
ADJ_KELPO	The qualitative gradation of p between vowels in o stems goes to v, the class for this is described here, the dictionary class for this is ¹⁻E.
ADJ_KOHELO	The o final trisyllabic stems are in class described here, and the old dictionaries used ².
ADJ_KOLKKO	The quantitative k gradations with o bisyllabic o stem use class described here, and old dictionaries use classes ¹⁻A and ¹⁻D.
ADJ_KOLMAS	the ordinals > 2 have s:nne stem variation, back vowel variant
ADJ_KORKEA	Adjectivest with ea finals with a:0 variation
ADJ_KULTA	Adjectives with  lta:lla stems
ADJ_KULUNUT	Lexicalised nut participles, back vowels (also for assimilated n)
ADJ_KYLMÄJÄRKINEN	Adjectives nen:se variations front harmony
ADJ_KYVYTÖN	Adjective caritives with tön:ttömä variation
ADJ_KYYTTÖ	Adjectives with ö stems and quantitative gradation of t before y is in class described here, which was ¹⁻C in the dictionary.
ADJ_KÄYPÄ	Adjectives with ä:0 and p:v variations
ADJ_KÖKKÖ	Asjectives with ö stems and quantitative k gradations with o bisyllabic ö stem use class described here, and old dictionaries use classes ¹⁻A and ¹⁻D.
ADJ_LAKO	Adjectives with o final bisyllabic stems with optional ’ is described here, this is a subset of dictionary class ¹⁻D.
ADJ_LATUSKA	Certain trisyllabic or longer a stems allow a lot of allomorphs and both a : o : 0 variations:
ADJ_LENKO	The adjectives with -nko stem belong to class described here, and the dictionary class was ¹⁻G.
ADJ_LÄHEMPI	Lexicalised comparatives with front vowels
ADJ_LÄHTEISYYS	Adjectives with yys:yyde variations
ADJ_LÄMMIN	Adjectives with mmin:mpimä variations
ADJ_LÄNTÄ	Adjectives with ä:0 variation and t:n variation
ADJ_LÄTYSKÄ	Adjectives with ä:ö and ä:0 variations
ADJ_LÖPERÖ	Adjectives with trisyllabic ö stem is classified described here.
ADJ_LÖRPPÖ	Adjectives with quantitative gradation of p before ö is in class described here and old dictionaries would use ¹⁻B.
ADJ_MARTO	Adjectives with quantitative gradation of t after r in o stems is in class described here, which corresponds to dictionary class ¹⁻J.
ADJ_MATALA	Adjectives with a:0 stem with optional a:e for comparative
ADJ_MATTA	The ta stem with j plurals is described here, and the dictionary class is ⁹-C.
ADJ_MELTO	The quantitative gradation of t after l in o stems is in class described here, which corresponds to dictionary class ¹⁻I.
ADJ_MIETO	The gradation of t ~ d after o is in class described here, the dictionary class for this is ¹⁻F.
ADJ_MUU	Monosyllabic uu-final adjectives
ADJ_MYKKÄ	Adjectives with ä:0 variation and k:0 gradation
ADJ_MÄRKÄ	Adjectives with kä:0 variation with obligatory kä:e for comparative
ADJ_MÄTÄ	Adjectives with ä:0 variation and t:d gradation
ADJ_NELJÄS	the ordinals > 2 have s:nne stem variation, front vowel variant
ADJ_OHUT	Adjectives with ut:ue variation
ADJ_OIKEE	adjectives with colloquial versions of ea stem, lexicalised
ADJ_OPAAKKI	Adjectives with quantitative k gradation, i final and back harmony are in class described here and dictionary class ⁵⁻A or ⁵⁻D.
ADJ_PAHIN	Lexicalised superlatives, back harmony
ADJ_PANTU	Adjectives with qualitative gradation of t after n in u stems is in class described here, which corresponds to dictionary class ¹⁻I. The common u stem after n is in nut participle’s passive’s back form (-tu):
ADJ_PARANNELTU	Adjectives with quantitative gradation of t after l in o stems is in class described here, which corresponds to dictionary class ¹⁻I. The common u stem after l is in nut participles passive (-tu):
ADJ_PARAS	irregular superlative 'paras' relexicalised (for parhaampi : parhain)
ADJ_PEEAA	monosyllabic adjectives with aa-final stems
ADJ_PIENI	Adjectives with i:e variation and consonant stemmed ntä partitives
ADJ_PIKKU	Non-inflecting adjectives, like pikku, eri etc.
ADJ_PINKKI	Adjectives with quantitative k gradation, i final and front harmony are in class described here and dictionary class ⁵⁻A or ⁵⁻D. There's no back vowel version of the bisyllabic gradating -ppi form.
ADJ_PITKÄ	Adjective pitkä (tkä : de variation)
ADJ_POHATTA	Adjectives with a-stem and t:0 variations
ADJ_POPPA	Adjectives with a-stem and p:0 variations 
ADJ_RAAKA	Adjectives with a-stem and k:’ variation, obligatory apostrophe
ADJ_RAITIS	Adjectives with tis:ttii variations, back harmony
ADJ_RAMPA	The pa : ma stem with e comparative and j plurals is described here, and the dictionary class is ⁹⁻H.
ADJ_REHTI	Stems with t ~ d gradation, i final and front harmony are in class described here and dictionary class ⁵⁻F. There are no adjectives with i stems with other gradations.
ADJ_REIPAS	Adjectives with pas:ppaa variation
ADJ_RIETAS	Adjectives with tas:ttaa variation
ADJ_RIIVIÖ	Adjectives with stems with ö after vowels go to class described here, and used the old dictionary class ³.
ADJ_RUMA	Adjectives with a:e comparatives in a:0 class use described here. No dictionary classification or ~¹⁰,
ADJ_RÄVÄKKÄ	Adjectives with kkä:k(k)ö variation with optional k in plurals
ADJ_SANKA	Adjectives with nka:ng variations
ADJ_SIPPI	Adjectives with quantitative p gradation, i final and front harmony are in class described here and dictionary class ⁵⁻B.
ADJ_SISIN	Lexicalised superlatives front harmony
ADJ_STYDI	Adjectives with i stems with front vowel harmony go to class described here, where old dictionary classification was ⁵.
ADJ_SUIPPO	Adjectives with quantitative gradation of p before o is in class described here and old dictionaries would use ¹⁻B.
ADJ_SUOMALAINEN	Adjective-nouns with nen:se variations back, nationalities etc.
ADJ_SUURI	Adjectives with i:e stems and consonant stemmed ta partitives
ADJ_SYMPPIS	Adjectives with s:ks stem variation, front harmony
ADJ_SYYPÄÄ	Monosyllabic adjectives with ää-stems
ADJ_SÄIKKY	Adjectives quantitative k gradations with y bisyllabic o stem use class described here, and old dictionaries use classes ¹⁻A and ¹⁻D.
ADJ_SÄKKÄRÄ	Adjectives with ä:ö:0 variations
ADJ_TARKKA	Adjectives with ka stem with e comparative and j plurals is described here, and the dictionary class is ⁹-A or ⁹⁻D.
ADJ_TERVE	Adjectives with e:ee variation front harmony
ADJ_TERÄVÄ	Adjectives with ä:0 variation and ä:e comparatives optionally
ADJ_TIIVIS	Adjectives with is:ii stem variation front
ADJ_TOOPE	New adjectives with e stem have same allomorph selection as old short unchanging bisyllabic u, y, o and ö stems, and no stem-internal variation. The classification for the back vowel variant of this class is described here, and old dictionaries used the class ⁸. They also have slightly greater probability for archaic form of plural genitive
ADJ_TUHTI	Adjectives with t ~ d gradation, i final and back harmony are in class described here and dictionary class ⁵⁻F.
ADJ_TUMMAHKO	Adjectives with o-stem belong here, the old dictionaries use class ¹. This class includes back vowel moderative derivations. N.B. the comparative derivation of moderatives is semantically awkward, but morphologically plausible.
ADJ_TURTA	Adjectives with rta-stems and t:r variation
ADJ_TYHMÄ	Adjectives with ä:e comparatives in ä:0 class. No dictionary classification or ~¹⁰,
ADJ_TYVEN	Adjectives with invariant consonant stems with 0:e stem
ADJ_TYYLIKÄS	Adjectives with käs:kkää stems
ADJ_TYÖLÄS	Adjectives with äs:ää stems
ADJ_TÄYSI	Adjectives with si:de stem variation, front
ADJ_UUSI	Adjectives with si:de stem variation, back
ADJ_VALKAISTU	Adjectives ending in u are in class described here, and in old dictionaries the class is ¹. Common part of this class is formed by nut participle passive’s _back_ vowel versions after s stem verbs
ADJ_VALMIS	Adjective with is:ii variation back
ADJ_VAPAA	There are no other bisyllabic long vowel stems in adjectives
ADJ_VASEN	Adjectives with n:mma variations
ADJ_VELTTO	Adjectives with quantitative gradation of t before o is in class described here, which was ¹⁻C in the dictionary.
ADJ_VENTO	Adjectives with gradation of t after n in o stems is in class described here, which corresponds to dictionary class ¹⁻J.
ADJ_VIATON	Adjectives with caritive ton:ttoma variations
ADJ_VIHANTA	Adjectives with nta:nna stem with a:o and the dictionary class is ⁹⁻J.
ADJ_VIHERIÄ	Archaic adjectives with iä:iö thing
ADJ_VIIPALOITU	Adjectives with gradation of t ~ d after u is in class described here, the dictionary class for this is ¹⁻F. The commonest t ~ d variation in u stems comes from nut participle’s passive’s back form (-tu).
ADJ_VIMMATTU	Adjectives with gradation t before u is in class described here, which was ¹⁻C in the dictionary. The u stems with quantitative t gradation are commonest with nut participle passive derivation’s back form (-ttu).
ADJ_VIRKKU	Adjectives with k gradations with u bisyllabic o stem use class described here, and old dictionaries use classes ¹⁻A and ¹⁻D.
ADJ_VOIMAKAS	Adjectives with kas:kkaa variation
ADJ_VOIPA	Adjectives with pa:va variation and a:0
ADJ_VÄHÄTELTY	The quantitative gradation of t after l in o stems is in class described here, which corresponds to dictionary class ¹⁻I. As with y and t:
ADJ_VÄNKÄ	Adjectives with nkä:ng variation
ADJ_VÄÄRTTI	Stems with quantitative t gradation, i final and front harmony are in class described here and dictionary class ⁵⁻C. There are no bisyllabic adjectives ending in vowel and gradating -pi.
ADJ_YKSILÖITY	The gradation of t ~ d after u is in class described here, the dictionary class for this is ¹⁻F. The commonest t ~ d variation in u stems comes from nut participle’s passive’s front form (-ty).
ADJ_YLENNETTY	The quantitative gradation of t before y is in class described here, which was ¹⁻C in the dictionary. The u stems with quantitative t gradation are commonest with nut participle passive derivation’s front (-tty).
ADJ_ÄLLISTYNYT	Dictionary class 47 front
ADJ_ÖYKKÄRI	The i stems with trisyllabic allomorph sets have class described here, and dictionary class of ⁶. There are no adjectives acting like nouns where i-final nominatives have singular e stems.
ADP_ALLE	adposition with optional possessive including -en allomorph, back harmony
ADP_KOTONA	adposition with optional possessive including -an allomorph
ADP_LISÄKSI	adposition with i:e stem variation beore optional possessive and -en allomorph, front harmony
ADP_LÄHELLÄ	adposition with optional possessive including -än allomorph
ADP_MUKAAN	adposition with optional possessive with -n assimilation, back harmony
ADP_MUKAISESTI	adposition without possessives, clitic with back harmony
ADP_NÄHDEN	adposition with de:te variation before optional possessive, front harmony
ADP_NÄKYVIIN	adposition with optional possessive with -n assimilation, front harmony
ADP_TYKÖ	adposition with optional possessive, front harmony
ADP_VALTAAN	adposition with optional possessive with -n assimilation, back harmony
ADP_VUOKSI	adposition with i:e stem variation beore optional possessive and -en allomorph, back harmony
ADP_YLLE	adposition with optional possessive including -en allomorph, front harmony
ADV_AIKANSA	Adverbs with clitics and back harmony
ADV_HYVILLÄÄN	Adverbs with obligatory possessives in ä stem, front harmony
ADV_IKINÄ	Adverbs with optional possessives
ADV_ILKOSILLAAN	Adverbs with obligatory possessives in a stem, back harmony
ADV_ISTUALLEEN	Adverbs with obligatory possessives in e stem, back harmony
ADV_JO	Adverbs that can only take ko clitic
ADV_JONNE	Adverbs with optional clitics, including ka
ADV_KUHUN	Adverbs with optional clitics, including kas
ADV_LEVÄLLEEN	Adverbs with obligatory possessives in e stem, front harmony
ADV_MITEN	Adverbs with optional clitics, including käs
ADV_NOPEASTI	Adverbs with optional clitics, back harmony
ADV_TYHMÄSTI	Adverbs with optional clitics, front harmony
ADV_VAAN	Adverbs with no clitics
ADV_YLIPÄÄNSÄ	Adverbs with optional clitics, front harmony
AUX_AIKOA	auxiliary version of ko:o verb stem
AUX_EI	Negation verb ‘ei’ has heteroclitic inflection
AUX_JOUTUA	auxiliary version of tu:du verb stem
AUX_MAHTAA	auxiliary version of ta:do verb stem
AUX_OLLA	auxiliary version of ‘olla’
AUX_PITÄÄ	auxiliary version of tä:dä verb stem
AUX_SAATTAA	auxiliary version of ttaa:to verb stem
AUX_TAITAA	auxiliary version of ta:si verb stem
AUX_TARVITA	auxiliary version of ta:tse verb stem
AUX_TÄYTYÄ	auxiliary version of ty:dy verb stem
AUX_VOIDA	auxiliary version of
CCONJ_JA	co-ordinating conjunction, no morphology
DET_SE	determiner version of pronoun ‘se’
DET_YKSI	determiner version of pronoun/numeral ‘yksi’
INTJ_HAH	interjection that does not participate in interjection compounding
INTJ_OO	interjection that participates in interjection compounding
NOUN_51aavameri	Optimisation hack for exceptional compound ’aavameri’ that inflects in all parts with agreement
NOUN_51hienosokeri	Optimisation hack for exceptional compound ’hienosokeri’ that inflects in all parts with agreement
NOUN_51isojako	Optimisation hack for exceptional compound ’isojako’ that inflects in all parts with agreement
NOUN_51isokoskelo	Optimisation hack for exceptional compound ’isokoskelo’ that inflects in all parts with agreement
NOUN_51isokuovi	Optimisation hack for exceptional compound ’isokuovi’ that inflects in all parts with agreement
NOUN_51isokäpylintu	Optimisation hack for exceptional compound ’isokäpylintu’ that inflects in all parts with agreement
NOUN_51isolepinkäinen	Optimisation hack for exceptional compound ’isolepinkäinen’ that inflects in all parts with agreement
NOUN_51isolokki	Optimisation hack for exceptional compound ’isolokki’ that inflects in all parts with agreement
NOUN_51isomaksaruoho	Optimisation hack for exceptional compound ’isomaksaruoho’ that inflects in all parts with agreement
NOUN_51isomasto	Optimisation hack for exceptional compound ’isomasto’ that inflects in all parts with agreement
NOUN_51isopanda	Optimisation hack for exceptional compound ’isopanda’ that inflects in all parts with agreement
NOUN_51isopistooli	Optimisation hack for exceptional compound ’isopistooli’ that inflects in all parts with agreement
NOUN_51isopurje	Optimisation hack for exceptional compound ’isopurje’ that inflects in all parts with agreement
NOUN_51isorokko	Optimisation hack for exceptional compound ’isorokko’ that inflects in all parts with agreement
NOUN_51isorumpu	Optimisation hack for exceptional compound ’isorumpu’ that inflects in all parts with agreement
NOUN_51isosisar	Optimisation hack for exceptional compound ’isosisar’ that inflects in all parts with agreement
NOUN_51isosisko	Optimisation hack for exceptional compound ’isosisko’ that inflects in all parts with agreement
NOUN_51isotaivot	Optimisation hack for exceptional compound ’isotaivot’ that inflects in all parts with agreement
NOUN_51isovarvas	Optimisation hack for exceptional compound ’isovarvas’ that inflects in all parts with agreement
NOUN_51isoveli	Optimisation hack for exceptional compound ’isoveli’ that inflects in all parts with agreement
NOUN_51isoviha	Optimisation hack for exceptional compound ’isoviha’ that inflects in all parts with agreement
NOUN_51karkearehu	Optimisation hack for exceptional compound ’karkearehu’ that inflects in all parts with agreement
NOUN_51kevytsarja	Optimisation hack for exceptional compound ’kevytsarja’ that inflects in all parts with agreement
NOUN_51kirjavapillike	Optimisation hack for exceptional compound ’kirjavapillike’ that inflects in all parts with agreement
NOUN_51kuivakakku	Optimisation hack for exceptional compound ’kuivakakku’ that inflects in all parts with agreement
NOUN_51kuivakukka	Optimisation hack for exceptional compound ’kuivakukka’ that inflects in all parts with agreement
NOUN_51kuivamuona	Optimisation hack for exceptional compound ’kuivamuona’ that inflects in all parts with agreement
NOUN_51kuivapaino	Optimisation hack for exceptional compound ’kuivapaino’ that inflects in all parts with agreement
NOUN_51kuivapari	Optimisation hack for exceptional compound ’kuivapari’ that inflects in all parts with agreement
NOUN_51kuivarehu	Optimisation hack for exceptional compound ’kuivarehu’ that inflects in all parts with agreement
NOUN_51kultainennoutaja	Optimisation hack for exceptional compound ’kultainennoutaja’ that inflects in all parts with agreement
NOUN_51laiskakoira	Optimisation hack for exceptional compound ’laiskakoira’ that inflects in all parts with agreement
NOUN_51lämminruoka	Optimisation hack for exceptional compound ’lämminruoka’ that inflects in all parts with agreement
NOUN_51lämminvarasto	Optimisation hack for exceptional compound ’lämminvarasto’ that inflects in all parts with agreement
NOUN_51lämminvaunu	Optimisation hack for exceptional compound ’lämminvaunu’ that inflects in all parts with agreement
NOUN_51matalameri	Optimisation hack for exceptional compound ’matalameri’ that inflects in all parts with agreement
NOUN_51mustaherukka	Optimisation hack for exceptional compound ’mustaherukka’ that inflects in all parts with agreement
NOUN_51mustaleipä	Optimisation hack for exceptional compound ’mustaleipä’ that inflects in all parts with agreement
NOUN_51mustaleski	Optimisation hack for exceptional compound ’mustaleski’ that inflects in all parts with agreement
NOUN_51mustalintu	Optimisation hack for exceptional compound ’mustalintu’ that inflects in all parts with agreement
NOUN_51mustamaija	Optimisation hack for exceptional compound ’mustamaija’ that inflects in all parts with agreement
NOUN_51mustamakkara	Optimisation hack for exceptional compound ’mustamakkara’ that inflects in all parts with agreement
NOUN_51mustamies	Optimisation hack for exceptional compound ’mustamies’ that inflects in all parts with agreement
NOUN_51mustamulta	Optimisation hack for exceptional compound ’mustamulta’ that inflects in all parts with agreement
NOUN_51mustapekka	Optimisation hack for exceptional compound ’mustapekka’ that inflects in all parts with agreement
NOUN_51mustapippuri	Optimisation hack for exceptional compound ’mustapippuri’ that inflects in all parts with agreement
NOUN_51mustaraamattu	Optimisation hack for exceptional compound ’mustaraamattu’ that inflects in all parts with agreement
NOUN_51mustatorvisieni	Optimisation hack for exceptional compound ’mustatorvisieni’ that inflects in all parts with agreement
NOUN_51mustaviinimarja	Optimisation hack for exceptional compound ’mustaviinimarja’ that inflects in all parts with agreement
NOUN_51nuoriemäntä	Optimisation hack for exceptional compound ’nuoriemäntä’ that inflects in all parts with agreement
NOUN_51nuoriherra	Optimisation hack for exceptional compound ’nuoriherra’ that inflects in all parts with agreement
NOUN_51nuori-isäntä	Optimisation hack for exceptional compound ’nuori-isäntä’ that inflects in all parts with agreement
NOUN_51nuorikarja	Optimisation hack for exceptional compound ’nuorikarja’ that inflects in all parts with agreement
NOUN_51nuorimies	Optimisation hack for exceptional compound ’nuorimies’ that inflects in all parts with agreement
NOUN_51nuoripari	Optimisation hack for exceptional compound ’nuoripari’ that inflects in all parts with agreement
NOUN_51omakuva	Optimisation hack for exceptional compound ’omakuva’ that inflects in all parts with agreement
NOUN_51omatunto	Optimisation hack for exceptional compound ’omatunto’ that inflects in all parts with agreement
NOUN_51pahahenki	Optimisation hack for exceptional compound ’pahahenki’ that inflects in all parts with agreement
NOUN_51pahaputki	Optimisation hack for exceptional compound ’pahaputki’ that inflects in all parts with agreement
NOUN_51palavakivi	Optimisation hack for exceptional compound ’palavakivi’ that inflects in all parts with agreement
NOUN_51palavapensas	Optimisation hack for exceptional compound ’palavapensas’ that inflects in all parts with agreement
NOUN_51palavarakkaus	Optimisation hack for exceptional compound ’palavarakkaus’ that inflects in all parts with agreement
NOUN_51pitkähousu	Optimisation hack for exceptional compound ’pitkähousu’ that inflects in all parts with agreement
NOUN_51pitkäkirkko	Optimisation hack for exceptional compound ’pitkäkirkko’ that inflects in all parts with agreement
NOUN_51pitkäperjantai	Optimisation hack for exceptional compound ’pitkäperjantai’ that inflects in all parts with agreement
NOUN_51pitkäpiimä	Optimisation hack for exceptional compound ’pitkäpiimä’ that inflects in all parts with agreement
NOUN_51pitkäsiima	Optimisation hack for exceptional compound ’pitkäsiima’ that inflects in all parts with agreement
NOUN_51pitkätakki	Optimisation hack for exceptional compound ’pitkätakki’ that inflects in all parts with agreement
NOUN_51pitkäthousut	Optimisation hack for exceptional compound ’pitkäthousut’ that inflects in all parts with agreement
NOUN_51puolikuu	Optimisation hack for exceptional compound ’puolikuu’ that inflects in all parts with agreement
NOUN_51puolimatka	Optimisation hack for exceptional compound ’puolimatka’ that inflects in all parts with agreement
NOUN_51puolipäivä	Optimisation hack for exceptional compound ’puolipäivä’ that inflects in all parts with agreement
NOUN_51puoliväli	Optimisation hack for exceptional compound ’puoliväli’ that inflects in all parts with agreement
NOUN_51puoliyö	Optimisation hack for exceptional compound ’puoliyö’ that inflects in all parts with agreement
NOUN_51raitisilma	Optimisation hack for exceptional compound ’raitisilma’ that inflects in all parts with agreement
NOUN_51raskassarja	Optimisation hack for exceptional compound ’raskassarja’ that inflects in all parts with agreement
NOUN_51raskasvesi	Optimisation hack for exceptional compound ’raskasvesi’ that inflects in all parts with agreement
NOUN_51raskasvety	Optimisation hack for exceptional compound ’raskasvety’ that inflects in all parts with agreement
NOUN_51sepiväpeippi	Optimisation hack for exceptional compound ’sepiväpeippi’ that inflects in all parts with agreement
NOUN_51suorakulma	Optimisation hack for exceptional compound ’suorakulma’ that inflects in all parts with agreement
NOUN_51suoraommel	Optimisation hack for exceptional compound ’suoraommel’ that inflects in all parts with agreement
NOUN_51syvämeri	Optimisation hack for exceptional compound ’syvämeri’ that inflects in all parts with agreement
NOUN_51särkynytsydän	Optimisation hack for exceptional compound ’särkynytsydän’ that inflects in all parts with agreement
NOUN_51tyhjäpaino	Optimisation hack for exceptional compound ’tyhjäpaino’ that inflects in all parts with agreement
NOUN_51täysikuu	Optimisation hack for exceptional compound ’täysikuu’ that inflects in all parts with agreement
NOUN_51uusikuu	Optimisation hack for exceptional compound ’uusikuu’ that inflects in all parts with agreement
NOUN_51uusivuosi	Optimisation hack for exceptional compound ’uusivuosi’ that inflects in all parts with agreement
NOUN_51vanhaemäntä	Optimisation hack for exceptional compound ’vanhaemäntä’ that inflects in all parts with agreement
NOUN_51vanhaisäntä	Optimisation hack for exceptional compound ’vanhaisäntä’ that inflects in all parts with agreement
NOUN_51vanhakaupunki	Optimisation hack for exceptional compound ’vanhakaupunki’ that inflects in all parts with agreement
NOUN_51vanhapiika	Optimisation hack for exceptional compound ’vanhapiika’ that inflects in all parts with agreement
NOUN_51vanhapoika	Optimisation hack for exceptional compound ’vanhapoika’ that inflects in all parts with agreement
NOUN_51vierasmies	Optimisation hack for exceptional compound ’vierasmies’ that inflects in all parts with agreement
NOUN_AAKKOSELLISUUS	Dictionary class 40 back
NOUN_AAKKOSTAMINEN	Dictionary class 38 back
NOUN_AALLOT	Dictionary class 1lot plurale tantum
NOUN_AAMUKAHDEKSAN	Non-dictionary class for numeral compounds ending 8
NOUN_AAMUKOLME	Non-dictionary class for numeral compounds ending kolme
NOUN_AAMUKYMMENEN	Non-dictionary class for numeral compounds ending 10
NOUN_AAMUYHDEKSÄN	Non-dictionary class for numeral compounds ending 9
NOUN_AAMUYKSI	Non-dictionary class for numeral compounds ending yksi
NOUN_AARRE	Dictionary class 48 back re
NOUN_ACRO_AA	acronyms ending in 'a' pronounced as a letter
NOUN_ACRO_CELSIUS	The acronyms ending in a word that inflects like ‘celsius’ with s:kse type stem
NOUN_ACRO_DOLLARI	The acronyms ending in a word that inflects like ‘dollari’ with i:e type stem
NOUN_ACRO_EE	acronyms ending in 'b', 'c', 'd', 'e', 'g', 'p', 'v', 'w' or 't' pronounced as a letter
NOUN_ACRO_GRAMMA	The acronyms ending in a word that inflects like ‘gramma’ with a:o type stem
NOUN_ACRO_GRAY	The acronyms ending in a word that inflects like ‘gray’ with y type stem
NOUN_ACRO_II	Acronyms that end in 'j' or 'i' pronoynced as letter
NOUN_ACRO_JOULE	The acronyms ending in a word that inflects like ‘joule’ with e type stem
NOUN_ACRO_JÄRJESTÖ	The acronyms ending in a word that inflects like ‘järjestö’ with ö type stem
NOUN_ACRO_KAHDEKSAN	Acronyms ending in 8
NOUN_ACRO_KAKSI	Acronyms ending in 2
NOUN_ACRO_KANDELA	The acronyms ending in a word that inflects like ‘kandela’ with a:0 type stem
NOUN_ACRO_KOLMAS	The acronyms ending in a word that inflects like ‘kolmas’ with s:nne type stem
NOUN_ACRO_KOLME	The acronyms ending in digit 3 pronounced as number
NOUN_ACRO_KUUSI	Acronyms ending in 6
NOUN_ACRO_LEHTI	The acronyms ending in a word that inflects like ‘lehti’ with i:e type stem
NOUN_ACRO_LUSIKKA	The acronyms ending in a word that inflects like ‘lusikka’ with a:o type stem
NOUN_ACRO_METRI	The acronyms ending in a word that inflects like ‘metri’ with i:e type stem
NOUN_ACRO_NELJÄ	Acronyms ending in 4
NOUN_ACRO_NOLLA	The acronyms ending in digit 0 pronounced as a number
NOUN_ACRO_OIKEUS	The acronyms ending in a word that inflects like ‘oikeus’ with s:de type stem
NOUN_ACRO_OK	The acronyms ending in a word that inflects like ‘ookoo’ with o:0 type stem
NOUN_ACRO_OO	Acronyms that end in 'h', 'k' or 'o' that is pronounced as a letter
NOUN_ACRO_OPISTO	The acronyms ending in a word that inflects like ‘opisto’ with o type stem
NOUN_ACRO_OPPILAS	The acronyms ending in a word that inflects like ‘oppilas’ with s:a type stem
NOUN_ACRO_PUNTA	The acronyms ending in a word that inflects like ‘punta’ with a:0 type stem
NOUN_ACRO_SAIRAALA	The acronyms ending in a word that inflects like ‘punta’ with a:o type stem
NOUN_ACRO_SEITSEMÄN	Acronyms ending in 7
NOUN_ACRO_TUOTE	The acronyms ending in a word that inflects like ‘tuote’ with e:ee type stem
NOUN_ACRO_UU	Acronyms that end in 'q', or 'u' pronounced as a letter
NOUN_ACRO_VIISI	The acronyms ending in digit 5 pronounced as number
NOUN_ACRO_VUOSI	The acronyms ending in a word that inflects like ‘vuosi’ with i:e type stem
NOUN_ACRO_WEBER	The acronyms ending in a word that inflects like ‘weber’ with r:re type stem
NOUN_ACRO_YHDISTYS	The acronyms ending in a word that inflects like ‘yhdistys’ with s:kse type stem
NOUN_ACRO_YKSI	Acronyms ending in 1
NOUN_ACRO_YY	Acronym that ends in 'y' pronounced as letter
NOUN_ACRO_ZET	Acronyms that end in 'z' pronounced as letter
NOUN_ACRO_ÄKS	Acronym that ends in 'f', 'l', 'm', 'n', 'r', 's', 'š' or 'x' pronounced as a letter
NOUN_ACRO_ÄÄ	Acronyms that end in 'ä' pronounced as letter
NOUN_ACRO_ÖÖ	Acronyms that end in 'ö' pronounced as letter
NOUN_ACRO_Ω	Acronyms that end in ‘oomega’
NOUN_AIKA	Nouns that inflect like aika:aja
NOUN_AIVOKUOLLUT	Dictionary class 47 back
NOUN_AIVOT	Dictionary class 1o plurale tantum
NOUN_AJATAR	Dictionary class 32 tar
NOUN_ALKEET	Dictionary class jeet plurale tantum
NOUN_ALKU	Dictionary class 1ku with k:0
NOUN_ALLAS	Dictionary class 41 las
NOUN_ANTIMET	Dictionary class 31 nnin plurale tantum
NOUN_APE	Dictionary class 48 back pe
NOUN_APU	Dictionary class 1pu
NOUN_ARISTOTELES	Dictionary class 41 es back
NOUN_ARKI	Dictionary class 7 back k~j
NOUN_ARKKITEHTI	Dictionary class 5 t~d with front and back harmony acceptable
NOUN_ASEMA	Dictionary class 11 back
NOUN_ASKAR	Dictionary class 49 ar
NOUN_ASKELLIN	Dictionary class 33 back lin
NOUN_ASTE	Dictionary class 48 back
NOUN_ASU	The stems ending in u are also without variationm and the bisyllabic ones have the same simple allomorph pattern: Dictionary class 1u
NOUN_ASUKAS	Dictionary class 41 kas
NOUN_ATERIMET	Dictionary class 31 t plurale tantum
NOUN_AUER	Dictionary class 49 auer
NOUN_BÉBÉ	Dictionary class 21 e front
NOUN_BEIGNET	Dictionary class 22 e front
NOUN_BERNIE	This class includes a set of new proper nouns that get nativised a bit Dictionary class 3etä
NOUN_BESSERWISSER	Dictionary class 6 front no i
NOUN_BIDEE	Dictionary class 20 e front There’s a gap in -ii final loan stems.
NOUN_BIKINIT	Dictionary class xxx nit plurale tantum
NOUN_BORDEAUX	Dictionary class 22 o
NOUN_BRASSERIE	Dictionary class 21 i back
NOUN_BRIE	Dictionary class 21 i front
NOUN_BÄNET	Dictionary class 8 front plurale tantum
NOUN_CHACHACHA	Dictionary class 21 a The loan words that end in consonant when written but vowel when pronounced are inflected with an apostrophe ’. With half-vowels the rule is a bit shaky, but officially apostrophe is the only way.
NOUN_COWBOY	Dictionary class 21 iy
NOUN_ELIN	Dictionary class 33 front
NOUN_ELÄMÄ	Dictionary class 11 front
NOUN_EPÄILTY	Dictionary class 1lty
NOUN_ESIM.	Abbreviated noun with final full stop and no morphology. At the moment covers parts-of-speech, may be split in the future
NOUN_ESQUIMAU	Dictionary class 21 o back
NOUN_FARKUT	Dictionary class 1ku plurale tantum
NOUN_FARMARIT	Dictionary class xxx it plurale tantum
NOUN_FONDUE	Dictionary class 21 ye
NOUN_FONDYY	Dictionary class 20 y
NOUN_FÄNRIKIT	Plurale tantum nouns that inflect with kit:kke
NOUN_GAY	Dictionary class 21 yi
NOUN_HAAKSI	Dictionary class 27 ksi
NOUN_HAI	Dictionary class 18 i back
NOUN_HAIT	Plurale tantum monosyllabic nouns ending in i, back harmony
NOUN_HAMMAS	Dictionary class 41 mas
NOUN_HAPAN	lexicalised noun of adjective hapan with n:ma variation
NOUN_HAPPI	Dictionary class 7 back p~0
NOUN_HAPPO	Dictionary class 1po
NOUN_HAPSI	Dictionary class 27 psi
NOUN_HARMAAT	Dictionary class 17 a plurale tantum
NOUN_HEITIN	Dictionary class 33 front tin
NOUN_HENKI	Dictionary class 7 front k~g
NOUN_HEPO	Dictionary class 1po
NOUN_HIIRI	Dictionary class 24 front It is noteworthy of the official dictionary classification, that classes with numbers 24 and 26 are identical. The distinction should probably not be retained in future versions.
NOUN_HIPAT	Dictionary class xxx a front pp plurale tantum
NOUN_HIRTTO	Dictionary class 1to
NOUN_HIUTALEET	Dictionary class leat plurale tantum
NOUN_HOKSOTTIMET	Dictionary class 31 tin plurale tantum
NOUN_HONKA	Dictionary class 10 back k~g
NOUN_HOPEAT	Dictionary class xxx eat plurale tantum
NOUN_HOUSUT	Dictionary class 1u plurale tantum
NOUN_HUOLITELTU	Dictionary class 1ltu
NOUN_HUPI	Dictionary class 5 back p~v There is a gap in i final words for p:v variation and front harmony
NOUN_HYLJE	Dictionary class 48 front je
NOUN_HYLKY	Dictionary class 1ky
NOUN_HYNTTEET	Dictionary class ntteet plurale tantum
NOUN_HYNTTYYT	Dictionary class ntyyaat plurale tantum
NOUN_HÄIRIÖ	Dictionary class 3ö
NOUN_HÄKKI	Dictionary class 5 front k~0
NOUN_HÄKKYRÄ	Dictionary class 12 front There is a possible class for further variation of a:o in the old dictionary dictionary that is worth re-evaluating. There’s one more allomorph pattern.
NOUN_HÄMMINKI	Dictionary class 5 front k~g There is a gap in i final paradigm with t:l variation and back vowels.
NOUN_HÄNTÄ	Dictionary class 10 front t~n
NOUN_HÄRKIN	Nouns with kin:kkime variation, front
NOUN_HÄVINNEET	Dictionary class nut plurale tantum
NOUN_HÄÄT	Dictionary class xxx äät plurale tantum
NOUN_HÄÄTÖ	Dictionary class 1tö
NOUN_HÖLKKÄ	Dictionary class 10 front k̃~0
NOUN_HÖPÖTTÄJÄ	Dictionary class 10 front
NOUN_HÖYHENET	Dictionary class 32 t plurale tantum
NOUN_IEN	Dictionary class 32 ien Some of the n-final stems have n:m variation.
NOUN_IES	Dictionary class 41 ies
NOUN_IKENET	Dictionary class 31 ien plurale tantum
NOUN_IMMYT	Dictionary class 43 myt Few t-final words have lengthening in singular stems
NOUN_ITÄMAAT	Dictionary class xxx maat plurale tantum
NOUN_JEPPE	Dictionary class 8 p~0 front
NOUN_JOCKEY	Dictionary class 21 yi
NOUN_JOUKOT	Dictionary class 1ko plurale tantum
NOUN_JOUTSEN	Dictionary class 32 back
NOUN_JUHLAT	Dictionary class xxx t plurale tantum
NOUN_JUMALA	a:0 with consonant stem ten genitive
NOUN_JÄLSI	Dictionary class 27 front t~l A few -psi, -ksi, -tsi stems have consonant simplification for consonant stems. Other variation with these stems is the selection of plural genitive allomorphs.
NOUN_JÄRKI	Dictionary class 7 front k~j
NOUN_JÄÄTELÖ	Dictionary class 2ö
NOUN_KAMPPEET	Dictionary class mppt plurale tantum
NOUN_KANAALI	Nouns with i:e variation
NOUN_KANGAS	Dictionary class 41 gas
NOUN_KANNEL	Dictionary class 49 nel
NOUN_KANNET	Dictionary class xxx nnet plurale tantum
NOUN_KARBOKSYLAATTI	gradating t:0 with both back and front harmonies
NOUN_KASTANJETIT	Dictionary class xxx tit plurale tantum
NOUN_KASTIKE	Dictionary class 48 back ke
NOUN_KASTILJAT	Plurale tantums with a:o variations
NOUN_KAUSI	Dictionary class 27 back
NOUN_KEHVELI	Dictionary class 6 front
NOUN_KELTIS	Dictionary class 41 tis
NOUN_KENGÄT	Dictionary class xxx a front kg plurale tantum
NOUN_KENKÄ	Dictionary class 10 frot k~g
NOUN_KENTTÄ	Dictionary class 10 front t~0
NOUN_KERITSIMET	Dictionary class 31 t fr plurale tantum
NOUN_KERROIN	Dictionary class 33 back roin
NOUN_KERTA	Dictionary class 9 t~r
NOUN_KEVÄT	Dictionary class 44 Nominalised nut participles have special inflection just as well.
NOUN_KIDE	Dictionary class 48 front de
NOUN_KIELTO	Dictionary class 1lto
NOUN_KIERRE	Dictionary class 48 fron re
NOUN_KIERRIN	Dictionary class 33 fron rin
NOUN_KIHARAT	Dictionary class xxxihi t plurale tantum
NOUN_KIHARRIN	Dictionary class 33 back rin
NOUN_KIINNE	Dictionary class 48 front ne
NOUN_KIIRU	archaic u:uu class c.f., s.v kiiruusti etc.
NOUN_KILPI	Dictionary class 7 front p~v
NOUN_KILPIKKÄÄT	Dictionary class 41 käs plurale tantum
NOUN_KINNAS	Dictionary class 41 nas
NOUN_KINNER	Dictionary class 49 ner
NOUN_KIRJA	Dictionary class 9 Notably, the basic a:o paradigm does not support many ä:ö cases.
NOUN_KIRVES	Dictionary class 41 es front
NOUN_KITARA	Nouns with a:o variations
NOUN_KIVI	Dictionary class 7 front
NOUN_KOE	Dictionary class 48 back 0k
NOUN_KOKO	k:’ should be obligatory but new rules allow k:0 for ‘koko’
NOUN_KOMPA	Dictionary class 10 back p~m
NOUN_KORPI	Dictionary class 7 back p~v
NOUN_KORTTI	Nouns with tti:te variations
NOUN_KUITU	Dictionary class 1to
NOUN_KUNGFU	Dictionary class 21 u back
NOUN_KUNTA	Dictionary class 10 back t~n
NOUN_KUOPAT	Dictionary class xxx a back p plurale tantum
NOUN_KUOPPA	Dictionary class 10 back p~0
NOUN_KUPPI	Dictionary class 5 back p~0
NOUN_KUTSUNTA	Dictionary class 9 t~n
NOUN_KUULOKKEET	Dictionary class kkkeeet plurale tantum
NOUN_KYDÖT	Plurale tantums for tö:dö stems
NOUN_KYKY	Dictionary class 1cyky
NOUN_KYLKIÄINEN	Dictionary class 38 front
NOUN_KYLÄNVANHIN	Lexicalised superlatives as nouns, front harmony
NOUN_KYSYNTÄ	Dictionary class 9 t~n front
NOUN_KYYNEL	Dictionary class 49 el
NOUN_KÄKI	Dictionary class 7 front k~0
NOUN_KÄMMEKKÄ	Dictionary class 14 front
NOUN_KÄPY	Dictionary class 1py
NOUN_KÄPÄLÄ	Dictionary class 11 front Some a stems with a:o variation have slightly different set of allomorphs
NOUN_KÄRRY	Dictionary class 1y
NOUN_KÄRSÄKÄS	Dictionary class 41 käs
NOUN_KÄRÄJÄT	Plurale tantums for ä:0 variations
NOUN_KÄSITE	Dictionary class 48 front te
NOUN_KÄÄDYT	Dictionary class 1dyt plurale tantum
NOUN_KÄÄNNIN	Dictionary class 33 frpnt nin
NOUN_KÄÄNTÖ	Dictionary class 1ntö
NOUN_KÖNGÄS	Dictionary class 41 gäs
NOUN_KÖYHYYS	Dictionary class 40 front Some s final words have special lengthening inflection.
NOUN_KÖYSI	Dictionary class 27 front
NOUN_KÖÖ	Dictionary class 18 ö
NOUN_LAHTI	Dictionary class 7 back t~d
NOUN_LAIDUN	Dictionary class 33 back dun
NOUN_LAKI	Dictionary class 5 back k~’~0
NOUN_LANKA	Dictionary class 9 k~g
NOUN_LAPSI	Dictionary class 27 psi
NOUN_LASIT	Dictionary class xxx sit plurale tantum
NOUN_LEHTI	Dictionary class 7 front t~d
NOUN_LEIKKUU	Dictionary class 17 u Monosyllabic long vowel stems have illative suffixes of form -hVn.
NOUN_LEIPÄ	Dictionary class 10 front p~v
NOUN_LEPAKKO	Dictionary class 4 kko
NOUN_LIEMI	Dictionary class 25 front The -si words that originate from old -te stems have the consonant gradation patterns left in their stems. The si is only in nominative stem and this class mainly concerns stems that are old enough to have undergone ti>si transformation.
NOUN_LIITTOUTUNEET	Dictionary class nut plurale tantum
NOUN_LIIVIT	Dictionary class xxx iiiit plurale tantum
NOUN_LINTU	Dictionary class 1ntu
NOUN_LIPEÄ	Dictionary class 15 eä
NOUN_LIPPU	Dictionary class 1pu
NOUN_LIUKU	Dictionary class 1ku with obligatory apostrophe k:’
NOUN_LOKA	Dictionary class 9 k~0 with optional ’
NOUN_LOKKI	Dictionary class 5 back k~0
NOUN_LUHDAT	Plurale tantums for a:0 and t:d variatiosn 
NOUN_LUKU	Dictionary class 1cuku
NOUN_LUMME	Dictionary class 48 back me
NOUN_LUODE	Nouns with de:tee variations back
NOUN_LUOKKA	Dictionary class 10 back k̃~0
NOUN_LUOLIKOT	Plurale tantums with kko:ko variations
NOUN_LUPA	Dictionary class 10 back p~v
NOUN_LUSIKKA	Dictionary class 14 back
NOUN_LÄHIN	Dictionary class 35 front
NOUN_LÄMMIN	lexicalised ADJ_LÄMMIN, that is a noun, has min:mpimä variation
NOUN_LÄMPÖ	Dictionary class 1mpö
NOUN_LÄNGET	Dictionary class xxx get plurale tantum
NOUN_LÄNSI	Dictionary class 27 front t~n
NOUN_LÄÄKE	Dictionary class 48 front ke
NOUN_LÖPÖ	Dictionary class 1pö
NOUN_MAA	Dictionary class 18 a
NOUN_MAKKARA	Dictionary class 12 back
NOUN_MAKU	Dictionary class 1ku
NOUN_MALTAAT	Dictionary class ltaat plurale tantum
NOUN_MANNER	Dictionary class 49 ner
NOUN_MARKKINAT	Dictionary class xxx a front plurale tantum
NOUN_MATEE	Nouns with long e stem and back harmony
NOUN_MERI	Non-Dictionary class meri
NOUN_MIELLE	Dictionary class 48 front le
NOUN_MIES	Dictionary class 42
NOUN_MILJÖÖ	Dictionary class 20 ö
NOUN_MILJÖÖT	Dictionary class 20 ö plurale tantum
NOUN_MITTA	Dictionary class 9 t~0
NOUN_MONSIEUR	Dictionary class 22 ö
NOUN_MULTA	Dictionary class 10 back t~l
NOUN_MUUNNIN	Dictionary class 33 back nin
NOUN_MYRKKY	Dictionary class 1ky
NOUN_MÄNTY	Dictionary class 1nty
NOUN_MÄTÄS	Dictionary class 41 täs
NOUN_MÖMMÖ	Dictionary class 1ö
NOUN_MÖRKÖ	Dictionary class 1rkö
NOUN_NALLE	Dictionary class 8 back
NOUN_NEITSYT	Dictionary class 43 front
NOUN_NEUVOTTELUT	Dictionary class 3lut plurale tantum
NOUN_NIHTI	Dictionary class 5 front t~d
NOUN_NIITUT	Plurale tantums with ttu:tut stems
NOUN_NIMETÖN	Dictionary class 34 tän
NOUN_NISSE	Dictionary class 8 front
NOUN_NOKI	Dictionary class 7 back k~0
NOUN_NOUGAT	Dictionary class 22 a
NOUN_NRO	Abbreviated noun without final full stop and no morphology. At the moment covers all nominal parts-of-speech, may be split in the future
NOUN_NUGAA	Dictionary class 20 a
NOUN_NUKKE	Dictionary class 8 k~0 back
NOUN_NYLJIN	Dictionary class 33 front jin
NOUN_NÄKY	Dictionary class 1ky
NOUN_NÄKÖ	Dictionary class 1kö
NOUN_NÄLKÄ	Dictionary class 10 front k~0
NOUN_OIKEUDET	Dictionary class sdet plurale tantum
NOUN_OLKA	Dictionary class 9 k~0 without optional ’
NOUN_OLUT	Dictionary class 43 back
NOUN_OMMEL	Dictionary class 49 mel
NOUN_ONKI	Dictionary class 7 back k~g
NOUN_ONNET	Plurale tantums with i:e variation
NOUN_ONNI	Dictionary class 7 back
NOUN_OOKOO	Dictionary class 18 o
NOUN_OPINNOT	Dictionary class 1not plurale tantum
NOUN_ORI	archaic i:ii class
NOUN_OSATON	Dictionary class 34 ton
NOUN_OSOITE	Nouns with te:ttee stems
NOUN_PAIKAT	Dictionary class xxx kAt plurale tantum
NOUN_PANKIT	Plurale tantums with kk:k and i:e variations
NOUN_PARFAIT	Dictionary class 22 e
NOUN_PATA	Dictionary class 9 t~d
NOUN_PATEE	Dictionary class 20 e
NOUN_PATSAS	Dictionary class 41 as
NOUN_PEIPOT	Plurale tantums with o-stems and pp:p gradation
NOUN_PELKO	k:0 without optional ’
NOUN_PELTI	Dictionary class 5 front t~l
NOUN_PENGER	Dictionary class 49 ger
NOUN_PERKEET	Dictionary class jeat plurale tantum
NOUN_PIDOT	Dictionary class 1ot plurale tantum
NOUN_PIENNAR	Dictionary class 49 nar
NOUN_PIHDIT	Dictionary class xxx dit front plurale tantum
NOUN_PII	Dictionary class 18 i
NOUN_PIIROA	dictionary class 15 oa, lexicalised ADJ_AINOA nouns
NOUN_PINSETIT	Plurale tantums with i:e stems and tt:t gradations
NOUN_PIPPALOT	Dictionary class 3iot plurale tantum
NOUN_PISTE	Dictionary class 48 Front
NOUN_POHATTA	Dictionary class 14 back t0
NOUN_POHJE	Dictionary class 48 back je
NOUN_POIKA	Non-dictionary class poika
NOUN_POIUT	exceptional stuff
NOUN_POJAT	Dictionary class pojat plurale tantum
NOUN_POLITIIKKA	Dictionary class 9 k~0
NOUN_POLJIN	Dictionary class 33 back jin
NOUN_PONSI	Dictionary class 27 back t~n
NOUN_PORRAS	Dictionary class 41 ras The word mies has special s:h variation pattern.
NOUN_PORTAAT	Dictionary class rtaat plurale tantum
NOUN_PROBLEEMA	Dictionary class 11 back
NOUN_PROTOLYYSI	Dictionary class 5 both
NOUN_PROTOLYYTTI	Dictionary class 5 both front and back harmony allowed
NOUN_PUHELIN	Dictionary class 33 back
NOUN_PUIN	Dictionary class 33 back k~in
NOUN_PUKIMET	Dictionary class 31 puin plurale tantum
NOUN_PUNK	New loan words ending in consonant may be inflected as i stem words Dictionary class 5 back no i
NOUN_PUU	Dictionary class 18 u
NOUN_PUUT	Dictionary class xx puu t plurale tantum
NOUN_PYRAMIDI	i:e with front and back harmony acceptable
NOUN_PYTTY	Dictionary class 1ty
NOUN_PYY	Dictionary class 18 y
NOUN_PYYHE	Dictionary class 48 front 0k
NOUN_PYYHIN	Dictionary class 33 front k~in
NOUN_PYYT	Dictionary class 18 y plurale tantum
NOUN_PÄÄ	Dictionary class 18 ä
NOUN_PÖKSYT	Dictionary class 1y plurale tantum
NOUN_PÖLLÖT	Plurale tantums with ö-stems
NOUN_PÖNTTÖ	Dictionary class 1tö
NOUN_PÖYTÄ	Dictionary class 10 front t~d
NOUN_RAAVIN	Dictionary class 33 front p~vin
NOUN_RAGUU	Dictionary class 20 u
NOUN_RAKENNE	Dictionary class 48 back ne
NOUN_RAMPA	Dictionary class 9 p~m
NOUN_RANGAT	Plurale tantums with nka:nga stems
NOUN_RAPPUSET	Dictionary class 38 nen plurale tantum
NOUN_RAPUT	Dictionary class 1put plurale tantum
NOUN_RATAS	Dictionary class 41 tas
NOUN_RATTAAT	Dictionary class taat plurale tantum
NOUN_RAUDAT	Dictionary class xxx dat plurale tantum
NOUN_RAUNIOT	Dictionary class 2iot plurale tantum
NOUN_RAVET	Dictionary class 8 plurale tantum
NOUN_RAVUT	Dictionary class 1vut plurale tantum
NOUN_REGGAE	class 21 with
NOUN_REIKÄ	Dictionary class 10 back k~’~0
NOUN_RENKAAT	Dictionary class gaat plurale tantum
NOUN_RIMPI	Dictionary class 7 front p~m
NOUN_RIPE	Dictionary class 48 front pe
NOUN_RIPSET	Dictionary class xxx ripset plurale tantum
NOUN_RIUTAT	Plurale tantums with a:o stems and tt:t gradation
NOUN_ROHTIMET	Dictionary class 33 fron din plurale tantum
NOUN_ROSÉ	Dictionary class 21 e back
NOUN_ROTAT	Dictionary class 9 t~0 plurale tantum
NOUN_ROTTA	Dictionary class 10 back t~0
NOUN_RUIPELO	Dictionary class 2o
NOUN_RUIS	Dictionary class 41 is
NOUN_RUMPU	Dictionary class 1mpu
NOUN_RUNKO	Dictionary class 1nko
NOUN_RUOKA	Like NOUN_LOKA but allows exceptional common spelling ruo’an ~ ruoan ̃~ ruuan
NOUN_RUOKO	Between three vowels where k is surrounded by same vowels the k becomes obligatorily ’. When the vowels are different, it becomes optionally ’ (as in N_TEKO), and after consonant other than s it is k ~ 0 (as in N_UKKO). Dictionary class 1ko
NOUN_RUUHI	Dictionary class 24 back
NOUN_RUUMIS	Dictionary class 41 is
NOUN_RUUVI	Dictionary class 5 back
NOUN_RYNNÄS	Dictionary class 41 näs
NOUN_RYNTTYYT	Dictionary class ntyyt plurale tantum
NOUN_RYNTÄÄT	Dictionary class ntääaat plurale tantum
NOUN_RYPÄS	Dictionary class 41 päs
NOUN_RYYPPY	Dictionary class 1py
NOUN_RÄJÄYTYS	Dictionary class 39 front Some of the s final stems have additional s:t:d variation in singular stems. Most notably, the UUs derivations are in this class.
NOUN_RÄMEET	Plurale tantums with e:ee stems, front harmony
NOUN_RÄMIÄT	Plurale tantums with iä-stem
NOUN_SAAPAS	Dictionary class 41 pas
NOUN_SAKSET	Dictionary class xxx sakset plurale tantum
NOUN_SALPA	Dictionary class 9 p~v
NOUN_SAMPI	Dictionary class 7 back p~m
NOUN_SAMPO	Dictionary class 1mpo
NOUN_SANKARI	like NOUN_HIIRI with optional extra consonant stems (sankar-)
NOUN_SEIKKAILU	Dictionary class 2u
NOUN_SEIVÄS	Dictionary class 41 väs
NOUN_SEPPÄ	Dictionary class 10 front p~0
NOUN_SERKUKSET	Dictionary class kset plurale tantum
NOUN_SHOW	Dictionary class 22 u
NOUN_SIEMEN	Dictionary class 32 front
NOUN_SIIRTO	Dictionary class 1rto
NOUN_SIIVILÄ	Dictionary class 12++ front
NOUN_SILAKAT	Dictionary class 14 kat plurale tantum
NOUN_SISÄLTÖ	Dictionary class 1ltö
NOUN_SIVELLIN	Dictionary class 33 frontlin
NOUN_SIVISTYNYT	Dictionary class 47 front
NOUN_SKEITTI	Dictionary class 5 front t~0
NOUN_SOINTI	Dictionary class 5 back t~n
NOUN_SOKEA	The a-final words ending in long vowels with syllable boundary have a:0 variation and more allomorphs for plyral genitive or illative. Dictionary class 15 ea
NOUN_SOTA	Dictionary class 10 back t~d
NOUN_STADION	Dictionary class 6 back no i
NOUN_SUHTEET	Dictionary class taad plurale tantum
NOUN_SUKAT	Dictionary class xxx a front k0 plurale tantum
NOUN_SULKA	Dictionary class 9 k~0 without optional ’
NOUN_SUODATIN	Dictionary class 33 back tin
NOUN_SUOMALAINEN	Dictionary class 38 back for the nationality ADJ/NOUN dual case
NOUN_SYDÄN	Like NOUN_ELIN, allows common non-standards of type: sydämmen, sytämen
NOUN_SYLI	Nouns with i:e stem and extra consonant stem stufff
NOUN_SYLTÄ	Dictionary class 10 front t~l
NOUN_SYNNYTTIMET	Dictionary class 31 tin front plurale tantum
NOUN_SYÖMINGIT	Dictionary class xxx git fornt plurale tantum
NOUN_SÄEN	Dictionary class 49 en
NOUN_SÄNKY	Dictionary class 1nky
NOUN_SÄRKÄT	Plurale tantums with ä:0 and kk:k gradation
NOUN_SÄRVIN	Dictionary class 33 front vin
NOUN_SÄÄDIN	Dictionary class 33 fron din
NOUN_SÄÄNNÖT	Dictionary class 1nöt plurale tantum
NOUN_SÄÄRET	Plurale tantums with i:e variation
NOUN_TAIMI	Dictionary class 25 back
NOUN_TAIVAL	Dictionary class 49 val
NOUN_TALKOOT	Dictionary class xxx kooot plurale tantum
NOUN_TALO	The most basic noun stem does not have any stem internal variation and uses few commonest allomorphs. The words in this class are either bisyllabic or have one of common derivational suffixes: sto, .... The nouns in this class end in o, u, y or ö, which determines their illative suffix and therefore exact classification:
NOUN_TANHUA	Nouns with a:o:0 variations
NOUN_TARPEET	Dictionary class veat plurale tantum
NOUN_TARVE	Dictionary class 48 back ve
NOUN_TAUDIT	Dictionary class xxx dit plurale tantum
NOUN_TAUTI	Dictionary class 5 back t~d
NOUN_TAVAT	Dictionary class xxx vat plurale tantum
NOUN_TEE	Dictionary class 18 e
NOUN_TEHDAS	Dictionary class 41 das
NOUN_TEKO	Between two vowels, the weak grade of k is optionally an apostrophe instead. For k that is not optionally ’, for example when it is after a consonant other than s, the variation is k ~ 0 instead (e.g. N_UKKO). Dictionary class 1ko
NOUN_TIE	Dictionary class 19 ie
NOUN_TIENOO	Dictionary class 17 o
NOUN_TIET	Dictionary class 15 tiet plurale tantum
NOUN_TIETEET	Dictionary class xxx teet plurale tantum
NOUN_TIKKAAT	Dictionary class kaat plurale tantum
NOUN_TIKKU	Dictionary class 1ku
NOUN_TIPPA	Dictionary class 9 p~0
NOUN_TOIMET	Dictionary class 25 t plurale tantum
NOUN_TOKEE	Dictionary class 20 e
NOUN_TONGIT	Dictionary class xxx git plurale tantum
NOUN_TORTTU	Dictionary class 1tu
NOUN_TRIKOO	Dictionary class 20 o
NOUN_TUHKA	Dictionary class 9 k~0 without optional k not gradating
NOUN_TULI	Dictionary class 23
NOUN_TUNNIT	Dictionary class 7 back t~n plurale tantum
NOUN_TUNTO	Dictionary class 1nto
NOUN_TUOMIO	The words with stem vowel o, u, y, ö preceded by vowels still have no more stem variation than other cases, but give yet another pattern of allomorphs for plural partitives and genitives Dictionary class 3o There's plenty of imaginable non-standard allomorph forms after long vowels
NOUN_TYPPI	Dictionary class 7 front p~0
NOUN_TYTÄR	Dictionary class 32 tär
NOUN_TYTÖT	Dictionary class 1töt plurale tantum
NOUN_TYYLI	Dictionary class 5 front
NOUN_TYYPPI	Dictionary class 5 front p~0
NOUN_TYÖ	Dictionary class 19 yö
NOUN_TYÖT	Dictionary class xxx työt plurale tantum
NOUN_TÖRPPÖ	Dictionary class 1pö
NOUN_UDAR	Dictionary class 49 dar
NOUN_UKKO	Dictionary class 1ko
NOUN_UKSI	Dictionary class 27 ksi
NOUN_ULAPPA	Dictionary class 14 back p̃0
NOUN_UROS	Non-Dictionary class uros
NOUN_VAADIN	Dictionary class 33 back din
NOUN_VAAKA	Dictionary class 9 k~’ with obligatory ’
NOUN_VAATTEET	Dictionary class teeeeet plurale tantum
NOUN_VAINAA	Dictionary class 17 a
NOUN_VAKUUTUS	Dictionary class 39 back
NOUN_VALJAAT	Dictionary class jaat plurale tantum
NOUN_VALLAT	Dictionary class xxx lat plurale tantum
NOUN_VALTA	Dictionary class 9 t~l
NOUN_VANHEMMAT	Dictionary class xxx matt plurale tantum
NOUN_VANHEMPI	Dictionary class 16
NOUN_VANKI	Dictionary class 5 back k~g
NOUN_VANTTUUT	Dictionary class ntyyaat plurale tantum
NOUN_VANTUS	Dictionary class 41 tus
NOUN_VARAS	Dictionary class 41 as
NOUN_VARAT	Dictionary class xxx rrt plurale tantum
NOUN_VARSI	Dictionary class 27 back t~r
NOUN_VARVAS	Dictionary class 41 vas
NOUN_VASEN	Dictionary class 35
NOUN_VEHKEILY	Dictionary class 2y
NOUN_VEITSI	Dictionary class 27 tsi front The -ksi stem in haaksi includes k:h variation.
NOUN_VELI	Non-dictionary class veli
NOUN_VEMMEL	Dictionary class 49 mel
NOUN_VERI	Non-Dictionary class veri
NOUN_VETIMET	Dictionary class 33 fron din plurale tantum
NOUN_VETO	Dictionary class 1to
NOUN_VETY	Dictionary class 1ty
NOUN_VIENTI	Dictionary class 5 front t~n
NOUN_VIHKIÄISET	Dictionary class 38 nen fornt plurale tantum
NOUN_VIHKO	k:0 with optional k not gradating
NOUN_VIIVE	Dictionary class 48 front ve
NOUN_VIKA	Dictionary class 9 k~’~0
NOUN_VINKU	Dictionary class 1nku
NOUN_VIRRET	Dictionary class 27 front t~r plurale tantum
NOUN_VIRSI	Dictionary class 27 front t~r
NOUN_VOIMA	Dictionary class 11 back
NOUN_VUO	Dictionary class 19 uo
NOUN_VUODET	Dictionary class 27 det plurale tantum
NOUN_VUOLLE	Dictionary class 48 back le
NOUN_VUOSITUHAT	Non-dictionary class for numeral compounds ending 1000
NOUN_YHTIÖT	Plurale tantum with iö-stem
NOUN_YKSIKKÖ	Dictionary class 4 kkö
NOUN_YLEIS	Bound nominal stems, that require compounding or hyphen
NOUN_YLKÄ	Dictionary class 9 k~0 without optional ’
NOUN_YLÄNKÖ	Dictionary class 1nkö
NOUN_YMPÄRYSTÄ	Nouns with ä:0 variations
NOUN_YSTÄVYKSET	Dictionary class kset fr plurale tantum
NOUN_YÖKKÖ	Dictionary class 1kö
NOUN_ZEN	Dictionary class 5 front no i
NOUN_ZOMBIE	Similar inflection exists in limited amounts in new loan words that are written as pronounced (thus taking no stem variation but still ending with long vowels with a syllable boundary) Dictionary class 3eta
NOUN_ÄYRÄS	Dictionary class 41 äs
NUM_51kahdeksanbiljardia	Optimisation hack for exceptional compound ’kahdeksanbiljardia’ that inflects in all parts with agreement
NUM_51kahdeksanbiljoonaa	Optimisation hack for exceptional compound ’kahdeksanbiljoonaa’ that inflects in all parts with agreement
NUM_51kahdeksandekiljardia	Optimisation hack for exceptional compound ’kahdeksandekiljardia’ that inflects in all parts with agreement
NUM_51kahdeksandekiljoonaa	Optimisation hack for exceptional compound ’kahdeksandekiljoonaa’ that inflects in all parts with agreement
NUM_51kahdeksanduodekiljardia	Optimisation hack for exceptional compound ’kahdeksanduodekiljardia’ that inflects in all parts with agreement
NUM_51kahdeksanduodekiljoonaa	Optimisation hack for exceptional compound ’kahdeksanduodekiljoonaa’ that inflects in all parts with agreement
NUM_51kahdeksankahdeksatta	Optimisation hack for exceptional compound ’kahdeksankahdeksatta’ that inflects in all parts with agreement
NUM_51kahdeksankiljardia	Optimisation hack for exceptional compound ’kahdeksankiljardia’ that inflects in all parts with agreement
NUM_51kahdeksankiljoonaa	Optimisation hack for exceptional compound ’kahdeksankiljoonaa’ that inflects in all parts with agreement
NUM_51kahdeksankolmatta	Optimisation hack for exceptional compound ’kahdeksankolmatta’ that inflects in all parts with agreement
NUM_51kahdeksankuudetta	Optimisation hack for exceptional compound ’kahdeksankuudetta’ that inflects in all parts with agreement
NUM_51kahdeksankvadriljardia	Optimisation hack for exceptional compound ’kahdeksankvadriljardia’ that inflects in all parts with agreement
NUM_51kahdeksankvadriljoonaa	Optimisation hack for exceptional compound ’kahdeksankvadriljoonaa’ that inflects in all parts with agreement
NUM_51kahdeksankvintiljardia	Optimisation hack for exceptional compound ’kahdeksankvintiljardia’ that inflects in all parts with agreement
NUM_51kahdeksankvintiljoonaa	Optimisation hack for exceptional compound ’kahdeksankvintiljoonaa’ that inflects in all parts with agreement
NUM_51kahdeksankymmentä	Optimisation hack for exceptional compound ’kahdeksankymmentä’ that inflects in all parts with agreement
NUM_51kahdeksanmiljardia	Optimisation hack for exceptional compound ’kahdeksanmiljardia’ that inflects in all parts with agreement
NUM_51kahdeksanmiljoonaa	Optimisation hack for exceptional compound ’kahdeksanmiljoonaa’ that inflects in all parts with agreement
NUM_51kahdeksanneljättä	Optimisation hack for exceptional compound ’kahdeksanneljättä’ that inflects in all parts with agreement
NUM_51kahdeksannoniljardia	Optimisation hack for exceptional compound ’kahdeksannoniljardia’ that inflects in all parts with agreement
NUM_51kahdeksannoniljoonaa	Optimisation hack for exceptional compound ’kahdeksannoniljoonaa’ that inflects in all parts with agreement
NUM_51kahdeksanoktiljardia	Optimisation hack for exceptional compound ’kahdeksanoktiljardia’ that inflects in all parts with agreement
NUM_51kahdeksanoktiljoonaa	Optimisation hack for exceptional compound ’kahdeksanoktiljoonaa’ that inflects in all parts with agreement
NUM_51kahdeksanpiljardia	Optimisation hack for exceptional compound ’kahdeksanpiljardia’ that inflects in all parts with agreement
NUM_51kahdeksanpiljoonaa	Optimisation hack for exceptional compound ’kahdeksanpiljoonaa’ that inflects in all parts with agreement
NUM_51kahdeksansataa	Optimisation hack for exceptional compound ’kahdeksansataa’ that inflects in all parts with agreement
NUM_51kahdeksanseitsemättä	Optimisation hack for exceptional compound ’kahdeksanseitsemättä’ that inflects in all parts with agreement
NUM_51kahdeksansentiljardia	Optimisation hack for exceptional compound ’kahdeksansentiljardia’ that inflects in all parts with agreement
NUM_51kahdeksansentiljoonaa	Optimisation hack for exceptional compound ’kahdeksansentiljoonaa’ that inflects in all parts with agreement
NUM_51kahdeksanseptiljardia	Optimisation hack for exceptional compound ’kahdeksanseptiljardia’ that inflects in all parts with agreement
NUM_51kahdeksanseptiljoonaa	Optimisation hack for exceptional compound ’kahdeksanseptiljoonaa’ that inflects in all parts with agreement
NUM_51kahdeksantoista	Optimisation hack for exceptional compound ’kahdeksantoista’ that inflects in all parts with agreement
NUM_51kahdeksantredekiljardia	Optimisation hack for exceptional compound ’kahdeksantredekiljardia’ that inflects in all parts with agreement
NUM_51kahdeksantredekiljoonaa	Optimisation hack for exceptional compound ’kahdeksantredekiljoonaa’ that inflects in all parts with agreement
NUM_51kahdeksantriljardia	Optimisation hack for exceptional compound ’kahdeksantriljardia’ that inflects in all parts with agreement
NUM_51kahdeksantriljoonaa	Optimisation hack for exceptional compound ’kahdeksantriljoonaa’ that inflects in all parts with agreement
NUM_51kahdeksantsiljardia	Optimisation hack for exceptional compound ’kahdeksantsiljardia’ that inflects in all parts with agreement
NUM_51kahdeksantsiljoonaa	Optimisation hack for exceptional compound ’kahdeksantsiljoonaa’ that inflects in all parts with agreement
NUM_51kahdeksantuhatta	Optimisation hack for exceptional compound ’kahdeksantuhatta’ that inflects in all parts with agreement
NUM_51kahdeksanundekiljardia	Optimisation hack for exceptional compound ’kahdeksanundekiljardia’ that inflects in all parts with agreement
NUM_51kahdeksanundekiljoonaa	Optimisation hack for exceptional compound ’kahdeksanundekiljoonaa’ that inflects in all parts with agreement
NUM_51kahdeksanviidettä	Optimisation hack for exceptional compound ’kahdeksanviidettä’ that inflects in all parts with agreement
NUM_51kahdeksanyhdeksättä	Optimisation hack for exceptional compound ’kahdeksanyhdeksättä’ that inflects in all parts with agreement
NUM_51kahdeksasbiljardis	Optimisation hack for exceptional compound ’kahdeksasbiljardis’ that inflects in all parts with agreement
NUM_51kahdeksasbiljoonas	Optimisation hack for exceptional compound ’kahdeksasbiljoonas’ that inflects in all parts with agreement
NUM_51kahdeksasdekiljardis	Optimisation hack for exceptional compound ’kahdeksasdekiljardis’ that inflects in all parts with agreement
NUM_51kahdeksasdekiljoonas	Optimisation hack for exceptional compound ’kahdeksasdekiljoonas’ that inflects in all parts with agreement
NUM_51kahdeksasduodekiljardis	Optimisation hack for exceptional compound ’kahdeksasduodekiljardis’ that inflects in all parts with agreement
NUM_51kahdeksasduodekiljoonas	Optimisation hack for exceptional compound ’kahdeksasduodekiljoonas’ that inflects in all parts with agreement
NUM_51kahdeksaskahdeksatta	Optimisation hack for exceptional compound ’kahdeksaskahdeksatta’ that inflects in all parts with agreement
NUM_51kahdeksaskiljardis	Optimisation hack for exceptional compound ’kahdeksaskiljardis’ that inflects in all parts with agreement
NUM_51kahdeksaskiljoonas	Optimisation hack for exceptional compound ’kahdeksaskiljoonas’ that inflects in all parts with agreement
NUM_51kahdeksaskolmatta	Optimisation hack for exceptional compound ’kahdeksaskolmatta’ that inflects in all parts with agreement
NUM_51kahdeksaskuudetta	Optimisation hack for exceptional compound ’kahdeksaskuudetta’ that inflects in all parts with agreement
NUM_51kahdeksaskvadriljardis	Optimisation hack for exceptional compound ’kahdeksaskvadriljardis’ that inflects in all parts with agreement
NUM_51kahdeksaskvadriljoonas	Optimisation hack for exceptional compound ’kahdeksaskvadriljoonas’ that inflects in all parts with agreement
NUM_51kahdeksaskvintiljardis	Optimisation hack for exceptional compound ’kahdeksaskvintiljardis’ that inflects in all parts with agreement
NUM_51kahdeksaskvintiljoonas	Optimisation hack for exceptional compound ’kahdeksaskvintiljoonas’ that inflects in all parts with agreement
NUM_51kahdeksaskymmenes	Optimisation hack for exceptional compound ’kahdeksaskymmenes’ that inflects in all parts with agreement
NUM_51kahdeksasmiljardis	Optimisation hack for exceptional compound ’kahdeksasmiljardis’ that inflects in all parts with agreement
NUM_51kahdeksasmiljoonas	Optimisation hack for exceptional compound ’kahdeksasmiljoonas’ that inflects in all parts with agreement
NUM_51kahdeksasneljästtä	Optimisation hack for exceptional compound ’kahdeksasneljästtä’ that inflects in all parts with agreement
NUM_51kahdeksasnoniljardis	Optimisation hack for exceptional compound ’kahdeksasnoniljardis’ that inflects in all parts with agreement
NUM_51kahdeksasnoniljoonas	Optimisation hack for exceptional compound ’kahdeksasnoniljoonas’ that inflects in all parts with agreement
NUM_51kahdeksasoktiljardis	Optimisation hack for exceptional compound ’kahdeksasoktiljardis’ that inflects in all parts with agreement
NUM_51kahdeksasoktiljoonas	Optimisation hack for exceptional compound ’kahdeksasoktiljoonas’ that inflects in all parts with agreement
NUM_51kahdeksaspiljardis	Optimisation hack for exceptional compound ’kahdeksaspiljardis’ that inflects in all parts with agreement
NUM_51kahdeksaspiljoonas	Optimisation hack for exceptional compound ’kahdeksaspiljoonas’ that inflects in all parts with agreement
NUM_51kahdeksassadas	Optimisation hack for exceptional compound ’kahdeksassadas’ that inflects in all parts with agreement
NUM_51kahdeksasseitsemättä	Optimisation hack for exceptional compound ’kahdeksasseitsemättä’ that inflects in all parts with agreement
NUM_51kahdeksassentiljardis	Optimisation hack for exceptional compound ’kahdeksassentiljardis’ that inflects in all parts with agreement
NUM_51kahdeksassentiljoonas	Optimisation hack for exceptional compound ’kahdeksassentiljoonas’ that inflects in all parts with agreement
NUM_51kahdeksasseptiljardis	Optimisation hack for exceptional compound ’kahdeksasseptiljardis’ that inflects in all parts with agreement
NUM_51kahdeksasseptiljoonas	Optimisation hack for exceptional compound ’kahdeksasseptiljoonas’ that inflects in all parts with agreement
NUM_51kahdeksastoista	Optimisation hack for exceptional compound ’kahdeksastoista’ that inflects in all parts with agreement
NUM_51kahdeksastredekiljardis	Optimisation hack for exceptional compound ’kahdeksastredekiljardis’ that inflects in all parts with agreement
NUM_51kahdeksastredekiljoonas	Optimisation hack for exceptional compound ’kahdeksastredekiljoonas’ that inflects in all parts with agreement
NUM_51kahdeksastriljardis	Optimisation hack for exceptional compound ’kahdeksastriljardis’ that inflects in all parts with agreement
NUM_51kahdeksastriljoonas	Optimisation hack for exceptional compound ’kahdeksastriljoonas’ that inflects in all parts with agreement
NUM_51kahdeksastsiljardis	Optimisation hack for exceptional compound ’kahdeksastsiljardis’ that inflects in all parts with agreement
NUM_51kahdeksastsiljoonas	Optimisation hack for exceptional compound ’kahdeksastsiljoonas’ that inflects in all parts with agreement
NUM_51kahdeksastuhannes	Optimisation hack for exceptional compound ’kahdeksastuhannes’ that inflects in all parts with agreement
NUM_51kahdeksasundekiljardis	Optimisation hack for exceptional compound ’kahdeksasundekiljardis’ that inflects in all parts with agreement
NUM_51kahdeksasundekiljoonas	Optimisation hack for exceptional compound ’kahdeksasundekiljoonas’ that inflects in all parts with agreement
NUM_51kahdeksasviidettä	Optimisation hack for exceptional compound ’kahdeksasviidettä’ that inflects in all parts with agreement
NUM_51kahdeksasyhdeksättä	Optimisation hack for exceptional compound ’kahdeksasyhdeksättä’ that inflects in all parts with agreement
NUM_51kahdesbiljardis	Optimisation hack for exceptional compound ’kahdesbiljardis’ that inflects in all parts with agreement
NUM_51kahdesbiljoonas	Optimisation hack for exceptional compound ’kahdesbiljoonas’ that inflects in all parts with agreement
NUM_51kahdesdekiljardis	Optimisation hack for exceptional compound ’kahdesdekiljardis’ that inflects in all parts with agreement
NUM_51kahdesdekiljoonas	Optimisation hack for exceptional compound ’kahdesdekiljoonas’ that inflects in all parts with agreement
NUM_51kahdesduodekiljardis	Optimisation hack for exceptional compound ’kahdesduodekiljardis’ that inflects in all parts with agreement
NUM_51kahdesduodekiljoonas	Optimisation hack for exceptional compound ’kahdesduodekiljoonas’ that inflects in all parts with agreement
NUM_51kahdeskahdeksatta	Optimisation hack for exceptional compound ’kahdeskahdeksatta’ that inflects in all parts with agreement
NUM_51kahdeskiljardis	Optimisation hack for exceptional compound ’kahdeskiljardis’ that inflects in all parts with agreement
NUM_51kahdeskiljoonas	Optimisation hack for exceptional compound ’kahdeskiljoonas’ that inflects in all parts with agreement
NUM_51kahdeskolmatta	Optimisation hack for exceptional compound ’kahdeskolmatta’ that inflects in all parts with agreement
NUM_51kahdeskuudetta	Optimisation hack for exceptional compound ’kahdeskuudetta’ that inflects in all parts with agreement
NUM_51kahdeskvadriljardis	Optimisation hack for exceptional compound ’kahdeskvadriljardis’ that inflects in all parts with agreement
NUM_51kahdeskvadriljoonas	Optimisation hack for exceptional compound ’kahdeskvadriljoonas’ that inflects in all parts with agreement
NUM_51kahdeskvintiljardis	Optimisation hack for exceptional compound ’kahdeskvintiljardis’ that inflects in all parts with agreement
NUM_51kahdeskvintiljoonas	Optimisation hack for exceptional compound ’kahdeskvintiljoonas’ that inflects in all parts with agreement
NUM_51kahdeskymmenes	Optimisation hack for exceptional compound ’kahdeskymmenes’ that inflects in all parts with agreement
NUM_51kahdesmiljardis	Optimisation hack for exceptional compound ’kahdesmiljardis’ that inflects in all parts with agreement
NUM_51kahdesmiljoonas	Optimisation hack for exceptional compound ’kahdesmiljoonas’ that inflects in all parts with agreement
NUM_51kahdesneljästtä	Optimisation hack for exceptional compound ’kahdesneljästtä’ that inflects in all parts with agreement
NUM_51kahdesnoniljardis	Optimisation hack for exceptional compound ’kahdesnoniljardis’ that inflects in all parts with agreement
NUM_51kahdesnoniljoonas	Optimisation hack for exceptional compound ’kahdesnoniljoonas’ that inflects in all parts with agreement
NUM_51kahdesoktiljardis	Optimisation hack for exceptional compound ’kahdesoktiljardis’ that inflects in all parts with agreement
NUM_51kahdesoktiljoonas	Optimisation hack for exceptional compound ’kahdesoktiljoonas’ that inflects in all parts with agreement
NUM_51kahdespiljardis	Optimisation hack for exceptional compound ’kahdespiljardis’ that inflects in all parts with agreement
NUM_51kahdespiljoonas	Optimisation hack for exceptional compound ’kahdespiljoonas’ that inflects in all parts with agreement
NUM_51kahdessadas	Optimisation hack for exceptional compound ’kahdessadas’ that inflects in all parts with agreement
NUM_51kahdesseitsemättä	Optimisation hack for exceptional compound ’kahdesseitsemättä’ that inflects in all parts with agreement
NUM_51kahdessentiljardis	Optimisation hack for exceptional compound ’kahdessentiljardis’ that inflects in all parts with agreement
NUM_51kahdessentiljoonas	Optimisation hack for exceptional compound ’kahdessentiljoonas’ that inflects in all parts with agreement
NUM_51kahdesseptiljardis	Optimisation hack for exceptional compound ’kahdesseptiljardis’ that inflects in all parts with agreement
NUM_51kahdesseptiljoonas	Optimisation hack for exceptional compound ’kahdesseptiljoonas’ that inflects in all parts with agreement
NUM_51kahdestoista	Optimisation hack for exceptional compound ’kahdestoista’ that inflects in all parts with agreement
NUM_51kahdestredekiljardis	Optimisation hack for exceptional compound ’kahdestredekiljardis’ that inflects in all parts with agreement
NUM_51kahdestredekiljoonas	Optimisation hack for exceptional compound ’kahdestredekiljoonas’ that inflects in all parts with agreement
NUM_51kahdestriljardis	Optimisation hack for exceptional compound ’kahdestriljardis’ that inflects in all parts with agreement
NUM_51kahdestriljoonas	Optimisation hack for exceptional compound ’kahdestriljoonas’ that inflects in all parts with agreement
NUM_51kahdestsiljardis	Optimisation hack for exceptional compound ’kahdestsiljardis’ that inflects in all parts with agreement
NUM_51kahdestsiljoonas	Optimisation hack for exceptional compound ’kahdestsiljoonas’ that inflects in all parts with agreement
NUM_51kahdestuhannes	Optimisation hack for exceptional compound ’kahdestuhannes’ that inflects in all parts with agreement
NUM_51kahdesundekiljardis	Optimisation hack for exceptional compound ’kahdesundekiljardis’ that inflects in all parts with agreement
NUM_51kahdesundekiljoonas	Optimisation hack for exceptional compound ’kahdesundekiljoonas’ that inflects in all parts with agreement
NUM_51kahdesviidettä	Optimisation hack for exceptional compound ’kahdesviidettä’ that inflects in all parts with agreement
NUM_51kahdesyhdeksättä	Optimisation hack for exceptional compound ’kahdesyhdeksättä’ that inflects in all parts with agreement
NUM_51kaksibiljardia	Optimisation hack for exceptional compound ’kaksibiljardia’ that inflects in all parts with agreement
NUM_51kaksibiljoonaa	Optimisation hack for exceptional compound ’kaksibiljoonaa’ that inflects in all parts with agreement
NUM_51kaksidekiljardia	Optimisation hack for exceptional compound ’kaksidekiljardia’ that inflects in all parts with agreement
NUM_51kaksidekiljoonaa	Optimisation hack for exceptional compound ’kaksidekiljoonaa’ that inflects in all parts with agreement
NUM_51kaksiduodekiljardia	Optimisation hack for exceptional compound ’kaksiduodekiljardia’ that inflects in all parts with agreement
NUM_51kaksiduodekiljoonaa	Optimisation hack for exceptional compound ’kaksiduodekiljoonaa’ that inflects in all parts with agreement
NUM_51kaksikahdeksatta	Optimisation hack for exceptional compound ’kaksikahdeksatta’ that inflects in all parts with agreement
NUM_51kaksikiljardia	Optimisation hack for exceptional compound ’kaksikiljardia’ that inflects in all parts with agreement
NUM_51kaksikiljoonaa	Optimisation hack for exceptional compound ’kaksikiljoonaa’ that inflects in all parts with agreement
NUM_51kaksikolmatta	Optimisation hack for exceptional compound ’kaksikolmatta’ that inflects in all parts with agreement
NUM_51kaksikuudetta	Optimisation hack for exceptional compound ’kaksikuudetta’ that inflects in all parts with agreement
NUM_51kaksikvadriljardia	Optimisation hack for exceptional compound ’kaksikvadriljardia’ that inflects in all parts with agreement
NUM_51kaksikvadriljoonaa	Optimisation hack for exceptional compound ’kaksikvadriljoonaa’ that inflects in all parts with agreement
NUM_51kaksikvintiljardia	Optimisation hack for exceptional compound ’kaksikvintiljardia’ that inflects in all parts with agreement
NUM_51kaksikvintiljoonaa	Optimisation hack for exceptional compound ’kaksikvintiljoonaa’ that inflects in all parts with agreement
NUM_51kaksikymmentä	Optimisation hack for exceptional compound ’kaksikymmentä’ that inflects in all parts with agreement
NUM_51kaksimiljardia	Optimisation hack for exceptional compound ’kaksimiljardia’ that inflects in all parts with agreement
NUM_51kaksimiljoonaa	Optimisation hack for exceptional compound ’kaksimiljoonaa’ that inflects in all parts with agreement
NUM_51kaksineljättä	Optimisation hack for exceptional compound ’kaksineljättä’ that inflects in all parts with agreement
NUM_51kaksinoniljardia	Optimisation hack for exceptional compound ’kaksinoniljardia’ that inflects in all parts with agreement
NUM_51kaksinoniljoonaa	Optimisation hack for exceptional compound ’kaksinoniljoonaa’ that inflects in all parts with agreement
NUM_51kaksioktiljardia	Optimisation hack for exceptional compound ’kaksioktiljardia’ that inflects in all parts with agreement
NUM_51kaksioktiljoonaa	Optimisation hack for exceptional compound ’kaksioktiljoonaa’ that inflects in all parts with agreement
NUM_51kaksipiljardia	Optimisation hack for exceptional compound ’kaksipiljardia’ that inflects in all parts with agreement
NUM_51kaksipiljoonaa	Optimisation hack for exceptional compound ’kaksipiljoonaa’ that inflects in all parts with agreement
NUM_51kaksisataa	Optimisation hack for exceptional compound ’kaksisataa’ that inflects in all parts with agreement
NUM_51kaksiseitsemättä	Optimisation hack for exceptional compound ’kaksiseitsemättä’ that inflects in all parts with agreement
NUM_51kaksisentiljardia	Optimisation hack for exceptional compound ’kaksisentiljardia’ that inflects in all parts with agreement
NUM_51kaksisentiljoonaa	Optimisation hack for exceptional compound ’kaksisentiljoonaa’ that inflects in all parts with agreement
NUM_51kaksiseptiljardia	Optimisation hack for exceptional compound ’kaksiseptiljardia’ that inflects in all parts with agreement
NUM_51kaksiseptiljoonaa	Optimisation hack for exceptional compound ’kaksiseptiljoonaa’ that inflects in all parts with agreement
NUM_51kaksitoista	Optimisation hack for exceptional compound ’kaksitoista’ that inflects in all parts with agreement
NUM_51kaksitredekiljardia	Optimisation hack for exceptional compound ’kaksitredekiljardia’ that inflects in all parts with agreement
NUM_51kaksitredekiljoonaa	Optimisation hack for exceptional compound ’kaksitredekiljoonaa’ that inflects in all parts with agreement
NUM_51kaksitriljardia	Optimisation hack for exceptional compound ’kaksitriljardia’ that inflects in all parts with agreement
NUM_51kaksitriljoonaa	Optimisation hack for exceptional compound ’kaksitriljoonaa’ that inflects in all parts with agreement
NUM_51kaksitsiljardia	Optimisation hack for exceptional compound ’kaksitsiljardia’ that inflects in all parts with agreement
NUM_51kaksitsiljoonaa	Optimisation hack for exceptional compound ’kaksitsiljoonaa’ that inflects in all parts with agreement
NUM_51kaksituhatta	Optimisation hack for exceptional compound ’kaksituhatta’ that inflects in all parts with agreement
NUM_51kaksiundekiljardia	Optimisation hack for exceptional compound ’kaksiundekiljardia’ that inflects in all parts with agreement
NUM_51kaksiundekiljoonaa	Optimisation hack for exceptional compound ’kaksiundekiljoonaa’ that inflects in all parts with agreement
NUM_51kaksiviidettä	Optimisation hack for exceptional compound ’kaksiviidettä’ that inflects in all parts with agreement
NUM_51kaksiyhdeksättä	Optimisation hack for exceptional compound ’kaksiyhdeksättä’ that inflects in all parts with agreement
NUM_51kolmasbiljardis	Optimisation hack for exceptional compound ’kolmasbiljardis’ that inflects in all parts with agreement
NUM_51kolmasbiljoonas	Optimisation hack for exceptional compound ’kolmasbiljoonas’ that inflects in all parts with agreement
NUM_51kolmasdekiljardis	Optimisation hack for exceptional compound ’kolmasdekiljardis’ that inflects in all parts with agreement
NUM_51kolmasdekiljoonas	Optimisation hack for exceptional compound ’kolmasdekiljoonas’ that inflects in all parts with agreement
NUM_51kolmasduodekiljardis	Optimisation hack for exceptional compound ’kolmasduodekiljardis’ that inflects in all parts with agreement
NUM_51kolmasduodekiljoonas	Optimisation hack for exceptional compound ’kolmasduodekiljoonas’ that inflects in all parts with agreement
NUM_51kolmaskahdeksatta	Optimisation hack for exceptional compound ’kolmaskahdeksatta’ that inflects in all parts with agreement
NUM_51kolmaskiljardis	Optimisation hack for exceptional compound ’kolmaskiljardis’ that inflects in all parts with agreement
NUM_51kolmaskiljoonas	Optimisation hack for exceptional compound ’kolmaskiljoonas’ that inflects in all parts with agreement
NUM_51kolmaskolmatta	Optimisation hack for exceptional compound ’kolmaskolmatta’ that inflects in all parts with agreement
NUM_51kolmaskuudetta	Optimisation hack for exceptional compound ’kolmaskuudetta’ that inflects in all parts with agreement
NUM_51kolmaskvadriljardis	Optimisation hack for exceptional compound ’kolmaskvadriljardis’ that inflects in all parts with agreement
NUM_51kolmaskvadriljoonas	Optimisation hack for exceptional compound ’kolmaskvadriljoonas’ that inflects in all parts with agreement
NUM_51kolmaskvintiljardis	Optimisation hack for exceptional compound ’kolmaskvintiljardis’ that inflects in all parts with agreement
NUM_51kolmaskvintiljoonas	Optimisation hack for exceptional compound ’kolmaskvintiljoonas’ that inflects in all parts with agreement
NUM_51kolmaskymmenes	Optimisation hack for exceptional compound ’kolmaskymmenes’ that inflects in all parts with agreement
NUM_51kolmasmiljardis	Optimisation hack for exceptional compound ’kolmasmiljardis’ that inflects in all parts with agreement
NUM_51kolmasmiljoonas	Optimisation hack for exceptional compound ’kolmasmiljoonas’ that inflects in all parts with agreement
NUM_51kolmasneljättä	Optimisation hack for exceptional compound ’kolmasneljättä’ that inflects in all parts with agreement
NUM_51kolmasnoniljardis	Optimisation hack for exceptional compound ’kolmasnoniljardis’ that inflects in all parts with agreement
NUM_51kolmasnoniljoonas	Optimisation hack for exceptional compound ’kolmasnoniljoonas’ that inflects in all parts with agreement
NUM_51kolmasoktiljardis	Optimisation hack for exceptional compound ’kolmasoktiljardis’ that inflects in all parts with agreement
NUM_51kolmasoktiljoonas	Optimisation hack for exceptional compound ’kolmasoktiljoonas’ that inflects in all parts with agreement
NUM_51kolmaspiljardis	Optimisation hack for exceptional compound ’kolmaspiljardis’ that inflects in all parts with agreement
NUM_51kolmaspiljoonas	Optimisation hack for exceptional compound ’kolmaspiljoonas’ that inflects in all parts with agreement
NUM_51kolmassadas	Optimisation hack for exceptional compound ’kolmassadas’ that inflects in all parts with agreement
NUM_51kolmasseitsemättä	Optimisation hack for exceptional compound ’kolmasseitsemättä’ that inflects in all parts with agreement
NUM_51kolmassentiljardis	Optimisation hack for exceptional compound ’kolmassentiljardis’ that inflects in all parts with agreement
NUM_51kolmassentiljoonas	Optimisation hack for exceptional compound ’kolmassentiljoonas’ that inflects in all parts with agreement
NUM_51kolmasseptiljardis	Optimisation hack for exceptional compound ’kolmasseptiljardis’ that inflects in all parts with agreement
NUM_51kolmasseptiljoonas	Optimisation hack for exceptional compound ’kolmasseptiljoonas’ that inflects in all parts with agreement
NUM_51kolmastoista	Optimisation hack for exceptional compound ’kolmastoista’ that inflects in all parts with agreement
NUM_51kolmastredekiljardis	Optimisation hack for exceptional compound ’kolmastredekiljardis’ that inflects in all parts with agreement
NUM_51kolmastredekiljoonas	Optimisation hack for exceptional compound ’kolmastredekiljoonas’ that inflects in all parts with agreement
NUM_51kolmastriljardis	Optimisation hack for exceptional compound ’kolmastriljardis’ that inflects in all parts with agreement
NUM_51kolmastriljoonas	Optimisation hack for exceptional compound ’kolmastriljoonas’ that inflects in all parts with agreement
NUM_51kolmastsiljardis	Optimisation hack for exceptional compound ’kolmastsiljardis’ that inflects in all parts with agreement
NUM_51kolmastsiljoonas	Optimisation hack for exceptional compound ’kolmastsiljoonas’ that inflects in all parts with agreement
NUM_51kolmastuhannes	Optimisation hack for exceptional compound ’kolmastuhannes’ that inflects in all parts with agreement
NUM_51kolmasundekiljardis	Optimisation hack for exceptional compound ’kolmasundekiljardis’ that inflects in all parts with agreement
NUM_51kolmasundekiljoonas	Optimisation hack for exceptional compound ’kolmasundekiljoonas’ that inflects in all parts with agreement
NUM_51kolmasviidettä	Optimisation hack for exceptional compound ’kolmasviidettä’ that inflects in all parts with agreement
NUM_51kolmasyhdeksättä	Optimisation hack for exceptional compound ’kolmasyhdeksättä’ that inflects in all parts with agreement
NUM_51kolmebiljardia	Optimisation hack for exceptional compound ’kolmebiljardia’ that inflects in all parts with agreement
NUM_51kolmebiljoonaa	Optimisation hack for exceptional compound ’kolmebiljoonaa’ that inflects in all parts with agreement
NUM_51kolmedekiljardia	Optimisation hack for exceptional compound ’kolmedekiljardia’ that inflects in all parts with agreement
NUM_51kolmedekiljoonaa	Optimisation hack for exceptional compound ’kolmedekiljoonaa’ that inflects in all parts with agreement
NUM_51kolmeduodekiljardia	Optimisation hack for exceptional compound ’kolmeduodekiljardia’ that inflects in all parts with agreement
NUM_51kolmeduodekiljoonaa	Optimisation hack for exceptional compound ’kolmeduodekiljoonaa’ that inflects in all parts with agreement
NUM_51kolmekahdeksatta	Optimisation hack for exceptional compound ’kolmekahdeksatta’ that inflects in all parts with agreement
NUM_51kolmekiljardia	Optimisation hack for exceptional compound ’kolmekiljardia’ that inflects in all parts with agreement
NUM_51kolmekiljoonaa	Optimisation hack for exceptional compound ’kolmekiljoonaa’ that inflects in all parts with agreement
NUM_51kolmekolmatta	Optimisation hack for exceptional compound ’kolmekolmatta’ that inflects in all parts with agreement
NUM_51kolmekuudetta	Optimisation hack for exceptional compound ’kolmekuudetta’ that inflects in all parts with agreement
NUM_51kolmekvadriljardia	Optimisation hack for exceptional compound ’kolmekvadriljardia’ that inflects in all parts with agreement
NUM_51kolmekvadriljoonaa	Optimisation hack for exceptional compound ’kolmekvadriljoonaa’ that inflects in all parts with agreement
NUM_51kolmekvintiljardia	Optimisation hack for exceptional compound ’kolmekvintiljardia’ that inflects in all parts with agreement
NUM_51kolmekvintiljoonaa	Optimisation hack for exceptional compound ’kolmekvintiljoonaa’ that inflects in all parts with agreement
NUM_51kolmekymmentä	Optimisation hack for exceptional compound ’kolmekymmentä’ that inflects in all parts with agreement
NUM_51kolmemiljardia	Optimisation hack for exceptional compound ’kolmemiljardia’ that inflects in all parts with agreement
NUM_51kolmemiljoonaa	Optimisation hack for exceptional compound ’kolmemiljoonaa’ that inflects in all parts with agreement
NUM_51kolmeneljättä	Optimisation hack for exceptional compound ’kolmeneljättä’ that inflects in all parts with agreement
NUM_51kolmenoniljardia	Optimisation hack for exceptional compound ’kolmenoniljardia’ that inflects in all parts with agreement
NUM_51kolmenoniljoonaa	Optimisation hack for exceptional compound ’kolmenoniljoonaa’ that inflects in all parts with agreement
NUM_51kolmeoktiljardia	Optimisation hack for exceptional compound ’kolmeoktiljardia’ that inflects in all parts with agreement
NUM_51kolmeoktiljoonaa	Optimisation hack for exceptional compound ’kolmeoktiljoonaa’ that inflects in all parts with agreement
NUM_51kolmepiljardia	Optimisation hack for exceptional compound ’kolmepiljardia’ that inflects in all parts with agreement
NUM_51kolmepiljoonaa	Optimisation hack for exceptional compound ’kolmepiljoonaa’ that inflects in all parts with agreement
NUM_51kolmesataa	Optimisation hack for exceptional compound ’kolmesataa’ that inflects in all parts with agreement
NUM_51kolmeseitsemättä	Optimisation hack for exceptional compound ’kolmeseitsemättä’ that inflects in all parts with agreement
NUM_51kolmesentiljardia	Optimisation hack for exceptional compound ’kolmesentiljardia’ that inflects in all parts with agreement
NUM_51kolmesentiljoonaa	Optimisation hack for exceptional compound ’kolmesentiljoonaa’ that inflects in all parts with agreement
NUM_51kolmeseptiljardia	Optimisation hack for exceptional compound ’kolmeseptiljardia’ that inflects in all parts with agreement
NUM_51kolmeseptiljoonaa	Optimisation hack for exceptional compound ’kolmeseptiljoonaa’ that inflects in all parts with agreement
NUM_51kolmetoista	Optimisation hack for exceptional compound ’kolmetoista’ that inflects in all parts with agreement
NUM_51kolmetredekiljardia	Optimisation hack for exceptional compound ’kolmetredekiljardia’ that inflects in all parts with agreement
NUM_51kolmetredekiljoonaa	Optimisation hack for exceptional compound ’kolmetredekiljoonaa’ that inflects in all parts with agreement
NUM_51kolmetriljardia	Optimisation hack for exceptional compound ’kolmetriljardia’ that inflects in all parts with agreement
NUM_51kolmetriljoonaa	Optimisation hack for exceptional compound ’kolmetriljoonaa’ that inflects in all parts with agreement
NUM_51kolmetsiljardia	Optimisation hack for exceptional compound ’kolmetsiljardia’ that inflects in all parts with agreement
NUM_51kolmetsiljoonaa	Optimisation hack for exceptional compound ’kolmetsiljoonaa’ that inflects in all parts with agreement
NUM_51kolmetuhatta	Optimisation hack for exceptional compound ’kolmetuhatta’ that inflects in all parts with agreement
NUM_51kolmeundekiljardia	Optimisation hack for exceptional compound ’kolmeundekiljardia’ that inflects in all parts with agreement
NUM_51kolmeundekiljoonaa	Optimisation hack for exceptional compound ’kolmeundekiljoonaa’ that inflects in all parts with agreement
NUM_51kolmeviidettä	Optimisation hack for exceptional compound ’kolmeviidettä’ that inflects in all parts with agreement
NUM_51kolmeyhdeksättä	Optimisation hack for exceptional compound ’kolmeyhdeksättä’ that inflects in all parts with agreement
NUM_51kuudesbiljardis	Optimisation hack for exceptional compound ’kuudesbiljardis’ that inflects in all parts with agreement
NUM_51kuudesbiljoonas	Optimisation hack for exceptional compound ’kuudesbiljoonas’ that inflects in all parts with agreement
NUM_51kuudesdekiljardis	Optimisation hack for exceptional compound ’kuudesdekiljardis’ that inflects in all parts with agreement
NUM_51kuudesdekiljoonas	Optimisation hack for exceptional compound ’kuudesdekiljoonas’ that inflects in all parts with agreement
NUM_51kuudesduodekiljardis	Optimisation hack for exceptional compound ’kuudesduodekiljardis’ that inflects in all parts with agreement
NUM_51kuudesduodekiljoonas	Optimisation hack for exceptional compound ’kuudesduodekiljoonas’ that inflects in all parts with agreement
NUM_51kuudeskahdeksatta	Optimisation hack for exceptional compound ’kuudeskahdeksatta’ that inflects in all parts with agreement
NUM_51kuudeskiljardis	Optimisation hack for exceptional compound ’kuudeskiljardis’ that inflects in all parts with agreement
NUM_51kuudeskiljoonas	Optimisation hack for exceptional compound ’kuudeskiljoonas’ that inflects in all parts with agreement
NUM_51kuudeskolmatta	Optimisation hack for exceptional compound ’kuudeskolmatta’ that inflects in all parts with agreement
NUM_51kuudeskuudetta	Optimisation hack for exceptional compound ’kuudeskuudetta’ that inflects in all parts with agreement
NUM_51kuudeskvadriljardis	Optimisation hack for exceptional compound ’kuudeskvadriljardis’ that inflects in all parts with agreement
NUM_51kuudeskvadriljoonas	Optimisation hack for exceptional compound ’kuudeskvadriljoonas’ that inflects in all parts with agreement
NUM_51kuudeskvintiljardis	Optimisation hack for exceptional compound ’kuudeskvintiljardis’ that inflects in all parts with agreement
NUM_51kuudeskvintiljoonas	Optimisation hack for exceptional compound ’kuudeskvintiljoonas’ that inflects in all parts with agreement
NUM_51kuudeskymmenes	Optimisation hack for exceptional compound ’kuudeskymmenes’ that inflects in all parts with agreement
NUM_51kuudesmiljardis	Optimisation hack for exceptional compound ’kuudesmiljardis’ that inflects in all parts with agreement
NUM_51kuudesmiljoonas	Optimisation hack for exceptional compound ’kuudesmiljoonas’ that inflects in all parts with agreement
NUM_51kuudesneljästtä	Optimisation hack for exceptional compound ’kuudesneljästtä’ that inflects in all parts with agreement
NUM_51kuudesnoniljardis	Optimisation hack for exceptional compound ’kuudesnoniljardis’ that inflects in all parts with agreement
NUM_51kuudesnoniljoonas	Optimisation hack for exceptional compound ’kuudesnoniljoonas’ that inflects in all parts with agreement
NUM_51kuudesoktiljardis	Optimisation hack for exceptional compound ’kuudesoktiljardis’ that inflects in all parts with agreement
NUM_51kuudesoktiljoonas	Optimisation hack for exceptional compound ’kuudesoktiljoonas’ that inflects in all parts with agreement
NUM_51kuudespiljardis	Optimisation hack for exceptional compound ’kuudespiljardis’ that inflects in all parts with agreement
NUM_51kuudespiljoonas	Optimisation hack for exceptional compound ’kuudespiljoonas’ that inflects in all parts with agreement
NUM_51kuudessadas	Optimisation hack for exceptional compound ’kuudessadas’ that inflects in all parts with agreement
NUM_51kuudesseitsemättä	Optimisation hack for exceptional compound ’kuudesseitsemättä’ that inflects in all parts with agreement
NUM_51kuudessentiljardis	Optimisation hack for exceptional compound ’kuudessentiljardis’ that inflects in all parts with agreement
NUM_51kuudessentiljoonas	Optimisation hack for exceptional compound ’kuudessentiljoonas’ that inflects in all parts with agreement
NUM_51kuudesseptiljardis	Optimisation hack for exceptional compound ’kuudesseptiljardis’ that inflects in all parts with agreement
NUM_51kuudesseptiljoonas	Optimisation hack for exceptional compound ’kuudesseptiljoonas’ that inflects in all parts with agreement
NUM_51kuudestoista	Optimisation hack for exceptional compound ’kuudestoista’ that inflects in all parts with agreement
NUM_51kuudestredekiljardis	Optimisation hack for exceptional compound ’kuudestredekiljardis’ that inflects in all parts with agreement
NUM_51kuudestredekiljoonas	Optimisation hack for exceptional compound ’kuudestredekiljoonas’ that inflects in all parts with agreement
NUM_51kuudestriljardis	Optimisation hack for exceptional compound ’kuudestriljardis’ that inflects in all parts with agreement
NUM_51kuudestriljoonas	Optimisation hack for exceptional compound ’kuudestriljoonas’ that inflects in all parts with agreement
NUM_51kuudestsiljardis	Optimisation hack for exceptional compound ’kuudestsiljardis’ that inflects in all parts with agreement
NUM_51kuudestsiljoonas	Optimisation hack for exceptional compound ’kuudestsiljoonas’ that inflects in all parts with agreement
NUM_51kuudestuhannes	Optimisation hack for exceptional compound ’kuudestuhannes’ that inflects in all parts with agreement
NUM_51kuudesundekiljardis	Optimisation hack for exceptional compound ’kuudesundekiljardis’ that inflects in all parts with agreement
NUM_51kuudesundekiljoonas	Optimisation hack for exceptional compound ’kuudesundekiljoonas’ that inflects in all parts with agreement
NUM_51kuudesviidettä	Optimisation hack for exceptional compound ’kuudesviidettä’ that inflects in all parts with agreement
NUM_51kuudesyhdeksättä	Optimisation hack for exceptional compound ’kuudesyhdeksättä’ that inflects in all parts with agreement
NUM_51kuusibiljardia	Optimisation hack for exceptional compound ’kuusibiljardia’ that inflects in all parts with agreement
NUM_51kuusibiljoonaa	Optimisation hack for exceptional compound ’kuusibiljoonaa’ that inflects in all parts with agreement
NUM_51kuusidekiljardia	Optimisation hack for exceptional compound ’kuusidekiljardia’ that inflects in all parts with agreement
NUM_51kuusidekiljoonaa	Optimisation hack for exceptional compound ’kuusidekiljoonaa’ that inflects in all parts with agreement
NUM_51kuusiduodekiljardia	Optimisation hack for exceptional compound ’kuusiduodekiljardia’ that inflects in all parts with agreement
NUM_51kuusiduodekiljoonaa	Optimisation hack for exceptional compound ’kuusiduodekiljoonaa’ that inflects in all parts with agreement
NUM_51kuusikahdeksatta	Optimisation hack for exceptional compound ’kuusikahdeksatta’ that inflects in all parts with agreement
NUM_51kuusikiljardia	Optimisation hack for exceptional compound ’kuusikiljardia’ that inflects in all parts with agreement
NUM_51kuusikiljoonaa	Optimisation hack for exceptional compound ’kuusikiljoonaa’ that inflects in all parts with agreement
NUM_51kuusikolmatta	Optimisation hack for exceptional compound ’kuusikolmatta’ that inflects in all parts with agreement
NUM_51kuusikuudetta	Optimisation hack for exceptional compound ’kuusikuudetta’ that inflects in all parts with agreement
NUM_51kuusikvadriljardia	Optimisation hack for exceptional compound ’kuusikvadriljardia’ that inflects in all parts with agreement
NUM_51kuusikvadriljoonaa	Optimisation hack for exceptional compound ’kuusikvadriljoonaa’ that inflects in all parts with agreement
NUM_51kuusikvintiljardia	Optimisation hack for exceptional compound ’kuusikvintiljardia’ that inflects in all parts with agreement
NUM_51kuusikvintiljoonaa	Optimisation hack for exceptional compound ’kuusikvintiljoonaa’ that inflects in all parts with agreement
NUM_51kuusikymmentä	Optimisation hack for exceptional compound ’kuusikymmentä’ that inflects in all parts with agreement
NUM_51kuusimiljardia	Optimisation hack for exceptional compound ’kuusimiljardia’ that inflects in all parts with agreement
NUM_51kuusimiljoonaa	Optimisation hack for exceptional compound ’kuusimiljoonaa’ that inflects in all parts with agreement
NUM_51kuusineljättä	Optimisation hack for exceptional compound ’kuusineljättä’ that inflects in all parts with agreement
NUM_51kuusinoniljardia	Optimisation hack for exceptional compound ’kuusinoniljardia’ that inflects in all parts with agreement
NUM_51kuusinoniljoonaa	Optimisation hack for exceptional compound ’kuusinoniljoonaa’ that inflects in all parts with agreement
NUM_51kuusioktiljardia	Optimisation hack for exceptional compound ’kuusioktiljardia’ that inflects in all parts with agreement
NUM_51kuusioktiljoonaa	Optimisation hack for exceptional compound ’kuusioktiljoonaa’ that inflects in all parts with agreement
NUM_51kuusipiljardia	Optimisation hack for exceptional compound ’kuusipiljardia’ that inflects in all parts with agreement
NUM_51kuusipiljoonaa	Optimisation hack for exceptional compound ’kuusipiljoonaa’ that inflects in all parts with agreement
NUM_51kuusisataa	Optimisation hack for exceptional compound ’kuusisataa’ that inflects in all parts with agreement
NUM_51kuusiseitsemättä	Optimisation hack for exceptional compound ’kuusiseitsemättä’ that inflects in all parts with agreement
NUM_51kuusisentiljardia	Optimisation hack for exceptional compound ’kuusisentiljardia’ that inflects in all parts with agreement
NUM_51kuusisentiljoonaa	Optimisation hack for exceptional compound ’kuusisentiljoonaa’ that inflects in all parts with agreement
NUM_51kuusiseptiljardia	Optimisation hack for exceptional compound ’kuusiseptiljardia’ that inflects in all parts with agreement
NUM_51kuusiseptiljoonaa	Optimisation hack for exceptional compound ’kuusiseptiljoonaa’ that inflects in all parts with agreement
NUM_51kuusitoista	Optimisation hack for exceptional compound ’kuusitoista’ that inflects in all parts with agreement
NUM_51kuusitredekiljardia	Optimisation hack for exceptional compound ’kuusitredekiljardia’ that inflects in all parts with agreement
NUM_51kuusitredekiljoonaa	Optimisation hack for exceptional compound ’kuusitredekiljoonaa’ that inflects in all parts with agreement
NUM_51kuusitriljardia	Optimisation hack for exceptional compound ’kuusitriljardia’ that inflects in all parts with agreement
NUM_51kuusitriljoonaa	Optimisation hack for exceptional compound ’kuusitriljoonaa’ that inflects in all parts with agreement
NUM_51kuusitsiljardia	Optimisation hack for exceptional compound ’kuusitsiljardia’ that inflects in all parts with agreement
NUM_51kuusitsiljoonaa	Optimisation hack for exceptional compound ’kuusitsiljoonaa’ that inflects in all parts with agreement
NUM_51kuusituhatta	Optimisation hack for exceptional compound ’kuusituhatta’ that inflects in all parts with agreement
NUM_51kuusiundekiljardia	Optimisation hack for exceptional compound ’kuusiundekiljardia’ that inflects in all parts with agreement
NUM_51kuusiundekiljoonaa	Optimisation hack for exceptional compound ’kuusiundekiljoonaa’ that inflects in all parts with agreement
NUM_51kuusiviidettä	Optimisation hack for exceptional compound ’kuusiviidettä’ that inflects in all parts with agreement
NUM_51kuusiyhdeksättä	Optimisation hack for exceptional compound ’kuusiyhdeksättä’ that inflects in all parts with agreement
NUM_51neljäbiljardia	Optimisation hack for exceptional compound ’neljäbiljardia’ that inflects in all parts with agreement
NUM_51neljäbiljoonaa	Optimisation hack for exceptional compound ’neljäbiljoonaa’ that inflects in all parts with agreement
NUM_51neljädekiljardia	Optimisation hack for exceptional compound ’neljädekiljardia’ that inflects in all parts with agreement
NUM_51neljädekiljoonaa	Optimisation hack for exceptional compound ’neljädekiljoonaa’ that inflects in all parts with agreement
NUM_51neljäduodekiljardia	Optimisation hack for exceptional compound ’neljäduodekiljardia’ that inflects in all parts with agreement
NUM_51neljäduodekiljoonaa	Optimisation hack for exceptional compound ’neljäduodekiljoonaa’ that inflects in all parts with agreement
NUM_51neljäkahdeksatta	Optimisation hack for exceptional compound ’neljäkahdeksatta’ that inflects in all parts with agreement
NUM_51neljäkiljardia	Optimisation hack for exceptional compound ’neljäkiljardia’ that inflects in all parts with agreement
NUM_51neljäkiljoonaa	Optimisation hack for exceptional compound ’neljäkiljoonaa’ that inflects in all parts with agreement
NUM_51neljäkolmatta	Optimisation hack for exceptional compound ’neljäkolmatta’ that inflects in all parts with agreement
NUM_51neljäkuudetta	Optimisation hack for exceptional compound ’neljäkuudetta’ that inflects in all parts with agreement
NUM_51neljäkvadriljardia	Optimisation hack for exceptional compound ’neljäkvadriljardia’ that inflects in all parts with agreement
NUM_51neljäkvadriljoonaa	Optimisation hack for exceptional compound ’neljäkvadriljoonaa’ that inflects in all parts with agreement
NUM_51neljäkvintiljardia	Optimisation hack for exceptional compound ’neljäkvintiljardia’ that inflects in all parts with agreement
NUM_51neljäkvintiljoonaa	Optimisation hack for exceptional compound ’neljäkvintiljoonaa’ that inflects in all parts with agreement
NUM_51neljäkymmentä	Optimisation hack for exceptional compound ’neljäkymmentä’ that inflects in all parts with agreement
NUM_51neljämiljardia	Optimisation hack for exceptional compound ’neljämiljardia’ that inflects in all parts with agreement
NUM_51neljämiljoonaa	Optimisation hack for exceptional compound ’neljämiljoonaa’ that inflects in all parts with agreement
NUM_51neljäneljättä	Optimisation hack for exceptional compound ’neljäneljättä’ that inflects in all parts with agreement
NUM_51neljänoniljardia	Optimisation hack for exceptional compound ’neljänoniljardia’ that inflects in all parts with agreement
NUM_51neljänoniljoonaa	Optimisation hack for exceptional compound ’neljänoniljoonaa’ that inflects in all parts with agreement
NUM_51neljäoktiljardia	Optimisation hack for exceptional compound ’neljäoktiljardia’ that inflects in all parts with agreement
NUM_51neljäoktiljoonaa	Optimisation hack for exceptional compound ’neljäoktiljoonaa’ that inflects in all parts with agreement
NUM_51neljäpiljardia	Optimisation hack for exceptional compound ’neljäpiljardia’ that inflects in all parts with agreement
NUM_51neljäpiljoonaa	Optimisation hack for exceptional compound ’neljäpiljoonaa’ that inflects in all parts with agreement
NUM_51neljäsataa	Optimisation hack for exceptional compound ’neljäsataa’ that inflects in all parts with agreement
NUM_51neljäsbiljardis	Optimisation hack for exceptional compound ’neljäsbiljardis’ that inflects in all parts with agreement
NUM_51neljäsbiljoonas	Optimisation hack for exceptional compound ’neljäsbiljoonas’ that inflects in all parts with agreement
NUM_51neljäsdekiljardis	Optimisation hack for exceptional compound ’neljäsdekiljardis’ that inflects in all parts with agreement
NUM_51neljäsdekiljoonas	Optimisation hack for exceptional compound ’neljäsdekiljoonas’ that inflects in all parts with agreement
NUM_51neljäsduodekiljardis	Optimisation hack for exceptional compound ’neljäsduodekiljardis’ that inflects in all parts with agreement
NUM_51neljäsduodekiljoonas	Optimisation hack for exceptional compound ’neljäsduodekiljoonas’ that inflects in all parts with agreement
NUM_51neljäseitsemättä	Optimisation hack for exceptional compound ’neljäseitsemättä’ that inflects in all parts with agreement
NUM_51neljäsentiljardia	Optimisation hack for exceptional compound ’neljäsentiljardia’ that inflects in all parts with agreement
NUM_51neljäsentiljoonaa	Optimisation hack for exceptional compound ’neljäsentiljoonaa’ that inflects in all parts with agreement
NUM_51neljäseptiljardia	Optimisation hack for exceptional compound ’neljäseptiljardia’ that inflects in all parts with agreement
NUM_51neljäseptiljoonaa	Optimisation hack for exceptional compound ’neljäseptiljoonaa’ that inflects in all parts with agreement
NUM_51neljäskahdeksatta	Optimisation hack for exceptional compound ’neljäskahdeksatta’ that inflects in all parts with agreement
NUM_51neljäskiljardis	Optimisation hack for exceptional compound ’neljäskiljardis’ that inflects in all parts with agreement
NUM_51neljäskiljoonas	Optimisation hack for exceptional compound ’neljäskiljoonas’ that inflects in all parts with agreement
NUM_51neljäskolmatta	Optimisation hack for exceptional compound ’neljäskolmatta’ that inflects in all parts with agreement
NUM_51neljäskuudetta	Optimisation hack for exceptional compound ’neljäskuudetta’ that inflects in all parts with agreement
NUM_51neljäskvadriljardis	Optimisation hack for exceptional compound ’neljäskvadriljardis’ that inflects in all parts with agreement
NUM_51neljäskvadriljoonas	Optimisation hack for exceptional compound ’neljäskvadriljoonas’ that inflects in all parts with agreement
NUM_51neljäskvintiljardis	Optimisation hack for exceptional compound ’neljäskvintiljardis’ that inflects in all parts with agreement
NUM_51neljäskvintiljoonas	Optimisation hack for exceptional compound ’neljäskvintiljoonas’ that inflects in all parts with agreement
NUM_51neljäskymmenes	Optimisation hack for exceptional compound ’neljäskymmenes’ that inflects in all parts with agreement
NUM_51neljäsmiljardis	Optimisation hack for exceptional compound ’neljäsmiljardis’ that inflects in all parts with agreement
NUM_51neljäsmiljoonas	Optimisation hack for exceptional compound ’neljäsmiljoonas’ that inflects in all parts with agreement
NUM_51neljäsneljättä	Optimisation hack for exceptional compound ’neljäsneljättä’ that inflects in all parts with agreement
NUM_51neljäsnoniljardis	Optimisation hack for exceptional compound ’neljäsnoniljardis’ that inflects in all parts with agreement
NUM_51neljäsnoniljoonas	Optimisation hack for exceptional compound ’neljäsnoniljoonas’ that inflects in all parts with agreement
NUM_51neljäsoktiljardis	Optimisation hack for exceptional compound ’neljäsoktiljardis’ that inflects in all parts with agreement
NUM_51neljäsoktiljoonas	Optimisation hack for exceptional compound ’neljäsoktiljoonas’ that inflects in all parts with agreement
NUM_51neljäspiljardis	Optimisation hack for exceptional compound ’neljäspiljardis’ that inflects in all parts with agreement
NUM_51neljäspiljoonas	Optimisation hack for exceptional compound ’neljäspiljoonas’ that inflects in all parts with agreement
NUM_51neljässadas	Optimisation hack for exceptional compound ’neljässadas’ that inflects in all parts with agreement
NUM_51neljässeitsemättä	Optimisation hack for exceptional compound ’neljässeitsemättä’ that inflects in all parts with agreement
NUM_51neljässentiljardis	Optimisation hack for exceptional compound ’neljässentiljardis’ that inflects in all parts with agreement
NUM_51neljässentiljoonas	Optimisation hack for exceptional compound ’neljässentiljoonas’ that inflects in all parts with agreement
NUM_51neljässeptiljardis	Optimisation hack for exceptional compound ’neljässeptiljardis’ that inflects in all parts with agreement
NUM_51neljässeptiljoonas	Optimisation hack for exceptional compound ’neljässeptiljoonas’ that inflects in all parts with agreement
NUM_51neljästoista	Optimisation hack for exceptional compound ’neljästoista’ that inflects in all parts with agreement
NUM_51neljästredekiljardis	Optimisation hack for exceptional compound ’neljästredekiljardis’ that inflects in all parts with agreement
NUM_51neljästredekiljoonas	Optimisation hack for exceptional compound ’neljästredekiljoonas’ that inflects in all parts with agreement
NUM_51neljästriljardis	Optimisation hack for exceptional compound ’neljästriljardis’ that inflects in all parts with agreement
NUM_51neljästriljoonas	Optimisation hack for exceptional compound ’neljästriljoonas’ that inflects in all parts with agreement
NUM_51neljästsiljardis	Optimisation hack for exceptional compound ’neljästsiljardis’ that inflects in all parts with agreement
NUM_51neljästsiljoonas	Optimisation hack for exceptional compound ’neljästsiljoonas’ that inflects in all parts with agreement
NUM_51neljästuhannes	Optimisation hack for exceptional compound ’neljästuhannes’ that inflects in all parts with agreement
NUM_51neljäsundekiljardis	Optimisation hack for exceptional compound ’neljäsundekiljardis’ that inflects in all parts with agreement
NUM_51neljäsundekiljoonas	Optimisation hack for exceptional compound ’neljäsundekiljoonas’ that inflects in all parts with agreement
NUM_51neljäsviidettä	Optimisation hack for exceptional compound ’neljäsviidettä’ that inflects in all parts with agreement
NUM_51neljäsyhdeksättä	Optimisation hack for exceptional compound ’neljäsyhdeksättä’ that inflects in all parts with agreement
NUM_51neljätoista	Optimisation hack for exceptional compound ’neljätoista’ that inflects in all parts with agreement
NUM_51neljätredekiljardia	Optimisation hack for exceptional compound ’neljätredekiljardia’ that inflects in all parts with agreement
NUM_51neljätredekiljoonaa	Optimisation hack for exceptional compound ’neljätredekiljoonaa’ that inflects in all parts with agreement
NUM_51neljätriljardia	Optimisation hack for exceptional compound ’neljätriljardia’ that inflects in all parts with agreement
NUM_51neljätriljoonaa	Optimisation hack for exceptional compound ’neljätriljoonaa’ that inflects in all parts with agreement
NUM_51neljätsiljardia	Optimisation hack for exceptional compound ’neljätsiljardia’ that inflects in all parts with agreement
NUM_51neljätsiljoonaa	Optimisation hack for exceptional compound ’neljätsiljoonaa’ that inflects in all parts with agreement
NUM_51neljätuhatta	Optimisation hack for exceptional compound ’neljätuhatta’ that inflects in all parts with agreement
NUM_51neljäundekiljardia	Optimisation hack for exceptional compound ’neljäundekiljardia’ that inflects in all parts with agreement
NUM_51neljäundekiljoonaa	Optimisation hack for exceptional compound ’neljäundekiljoonaa’ that inflects in all parts with agreement
NUM_51neljäviidettä	Optimisation hack for exceptional compound ’neljäviidettä’ that inflects in all parts with agreement
NUM_51neljäyhdeksättä	Optimisation hack for exceptional compound ’neljäyhdeksättä’ that inflects in all parts with agreement
NUM_51puolitoista	Optimisation hack for exceptional compound ’puolitoista’ that inflects in all parts with agreement
NUM_51seitsemänbiljardia	Optimisation hack for exceptional compound ’seitsemänbiljardia’ that inflects in all parts with agreement
NUM_51seitsemänbiljoonaa	Optimisation hack for exceptional compound ’seitsemänbiljoonaa’ that inflects in all parts with agreement
NUM_51seitsemändekiljardia	Optimisation hack for exceptional compound ’seitsemändekiljardia’ that inflects in all parts with agreement
NUM_51seitsemändekiljoonaa	Optimisation hack for exceptional compound ’seitsemändekiljoonaa’ that inflects in all parts with agreement
NUM_51seitsemänduodekiljardia	Optimisation hack for exceptional compound ’seitsemänduodekiljardia’ that inflects in all parts with agreement
NUM_51seitsemänduodekiljoonaa	Optimisation hack for exceptional compound ’seitsemänduodekiljoonaa’ that inflects in all parts with agreement
NUM_51seitsemänkahdeksatta	Optimisation hack for exceptional compound ’seitsemänkahdeksatta’ that inflects in all parts with agreement
NUM_51seitsemänkiljardia	Optimisation hack for exceptional compound ’seitsemänkiljardia’ that inflects in all parts with agreement
NUM_51seitsemänkiljoonaa	Optimisation hack for exceptional compound ’seitsemänkiljoonaa’ that inflects in all parts with agreement
NUM_51seitsemänkolmatta	Optimisation hack for exceptional compound ’seitsemänkolmatta’ that inflects in all parts with agreement
NUM_51seitsemänkuudetta	Optimisation hack for exceptional compound ’seitsemänkuudetta’ that inflects in all parts with agreement
NUM_51seitsemänkvadriljardia	Optimisation hack for exceptional compound ’seitsemänkvadriljardia’ that inflects in all parts with agreement
NUM_51seitsemänkvadriljoonaa	Optimisation hack for exceptional compound ’seitsemänkvadriljoonaa’ that inflects in all parts with agreement
NUM_51seitsemänkvintiljardia	Optimisation hack for exceptional compound ’seitsemänkvintiljardia’ that inflects in all parts with agreement
NUM_51seitsemänkvintiljoonaa	Optimisation hack for exceptional compound ’seitsemänkvintiljoonaa’ that inflects in all parts with agreement
NUM_51seitsemänkymmentä	Optimisation hack for exceptional compound ’seitsemänkymmentä’ that inflects in all parts with agreement
NUM_51seitsemänmiljardia	Optimisation hack for exceptional compound ’seitsemänmiljardia’ that inflects in all parts with agreement
NUM_51seitsemänmiljoonaa	Optimisation hack for exceptional compound ’seitsemänmiljoonaa’ that inflects in all parts with agreement
NUM_51seitsemänneljättä	Optimisation hack for exceptional compound ’seitsemänneljättä’ that inflects in all parts with agreement
NUM_51seitsemännoniljardia	Optimisation hack for exceptional compound ’seitsemännoniljardia’ that inflects in all parts with agreement
NUM_51seitsemännoniljoonaa	Optimisation hack for exceptional compound ’seitsemännoniljoonaa’ that inflects in all parts with agreement
NUM_51seitsemänoktiljardia	Optimisation hack for exceptional compound ’seitsemänoktiljardia’ that inflects in all parts with agreement
NUM_51seitsemänoktiljoonaa	Optimisation hack for exceptional compound ’seitsemänoktiljoonaa’ that inflects in all parts with agreement
NUM_51seitsemänpiljardia	Optimisation hack for exceptional compound ’seitsemänpiljardia’ that inflects in all parts with agreement
NUM_51seitsemänpiljoonaa	Optimisation hack for exceptional compound ’seitsemänpiljoonaa’ that inflects in all parts with agreement
NUM_51seitsemänsataa	Optimisation hack for exceptional compound ’seitsemänsataa’ that inflects in all parts with agreement
NUM_51seitsemänseitsemättä	Optimisation hack for exceptional compound ’seitsemänseitsemättä’ that inflects in all parts with agreement
NUM_51seitsemänsentiljardia	Optimisation hack for exceptional compound ’seitsemänsentiljardia’ that inflects in all parts with agreement
NUM_51seitsemänsentiljoonaa	Optimisation hack for exceptional compound ’seitsemänsentiljoonaa’ that inflects in all parts with agreement
NUM_51seitsemänseptiljardia	Optimisation hack for exceptional compound ’seitsemänseptiljardia’ that inflects in all parts with agreement
NUM_51seitsemänseptiljoonaa	Optimisation hack for exceptional compound ’seitsemänseptiljoonaa’ that inflects in all parts with agreement
NUM_51seitsemäntoista	Optimisation hack for exceptional compound ’seitsemäntoista’ that inflects in all parts with agreement
NUM_51seitsemäntredekiljardia	Optimisation hack for exceptional compound ’seitsemäntredekiljardia’ that inflects in all parts with agreement
NUM_51seitsemäntredekiljoonaa	Optimisation hack for exceptional compound ’seitsemäntredekiljoonaa’ that inflects in all parts with agreement
NUM_51seitsemäntriljardia	Optimisation hack for exceptional compound ’seitsemäntriljardia’ that inflects in all parts with agreement
NUM_51seitsemäntriljoonaa	Optimisation hack for exceptional compound ’seitsemäntriljoonaa’ that inflects in all parts with agreement
NUM_51seitsemäntsiljardia	Optimisation hack for exceptional compound ’seitsemäntsiljardia’ that inflects in all parts with agreement
NUM_51seitsemäntsiljoonaa	Optimisation hack for exceptional compound ’seitsemäntsiljoonaa’ that inflects in all parts with agreement
NUM_51seitsemäntuhatta	Optimisation hack for exceptional compound ’seitsemäntuhatta’ that inflects in all parts with agreement
NUM_51seitsemänundekiljardia	Optimisation hack for exceptional compound ’seitsemänundekiljardia’ that inflects in all parts with agreement
NUM_51seitsemänundekiljoonaa	Optimisation hack for exceptional compound ’seitsemänundekiljoonaa’ that inflects in all parts with agreement
NUM_51seitsemänviidettä	Optimisation hack for exceptional compound ’seitsemänviidettä’ that inflects in all parts with agreement
NUM_51seitsemänyhdeksättä	Optimisation hack for exceptional compound ’seitsemänyhdeksättä’ that inflects in all parts with agreement
NUM_51seitsemäsbiljardis	Optimisation hack for exceptional compound ’seitsemäsbiljardis’ that inflects in all parts with agreement
NUM_51seitsemäsbiljoonas	Optimisation hack for exceptional compound ’seitsemäsbiljoonas’ that inflects in all parts with agreement
NUM_51seitsemäsdekiljardis	Optimisation hack for exceptional compound ’seitsemäsdekiljardis’ that inflects in all parts with agreement
NUM_51seitsemäsdekiljoonas	Optimisation hack for exceptional compound ’seitsemäsdekiljoonas’ that inflects in all parts with agreement
NUM_51seitsemäsduodekiljardis	Optimisation hack for exceptional compound ’seitsemäsduodekiljardis’ that inflects in all parts with agreement
NUM_51seitsemäsduodekiljoonas	Optimisation hack for exceptional compound ’seitsemäsduodekiljoonas’ that inflects in all parts with agreement
NUM_51seitsemäskahdeksatta	Optimisation hack for exceptional compound ’seitsemäskahdeksatta’ that inflects in all parts with agreement
NUM_51seitsemäskiljardis	Optimisation hack for exceptional compound ’seitsemäskiljardis’ that inflects in all parts with agreement
NUM_51seitsemäskiljoonas	Optimisation hack for exceptional compound ’seitsemäskiljoonas’ that inflects in all parts with agreement
NUM_51seitsemäskolmatta	Optimisation hack for exceptional compound ’seitsemäskolmatta’ that inflects in all parts with agreement
NUM_51seitsemäskuudetta	Optimisation hack for exceptional compound ’seitsemäskuudetta’ that inflects in all parts with agreement
NUM_51seitsemäskvadriljardis	Optimisation hack for exceptional compound ’seitsemäskvadriljardis’ that inflects in all parts with agreement
NUM_51seitsemäskvadriljoonas	Optimisation hack for exceptional compound ’seitsemäskvadriljoonas’ that inflects in all parts with agreement
NUM_51seitsemäskvintiljardis	Optimisation hack for exceptional compound ’seitsemäskvintiljardis’ that inflects in all parts with agreement
NUM_51seitsemäskvintiljoonas	Optimisation hack for exceptional compound ’seitsemäskvintiljoonas’ that inflects in all parts with agreement
NUM_51seitsemäskymmenes	Optimisation hack for exceptional compound ’seitsemäskymmenes’ that inflects in all parts with agreement
NUM_51seitsemäsmiljardis	Optimisation hack for exceptional compound ’seitsemäsmiljardis’ that inflects in all parts with agreement
NUM_51seitsemäsmiljoonas	Optimisation hack for exceptional compound ’seitsemäsmiljoonas’ that inflects in all parts with agreement
NUM_51seitsemäsneljästtä	Optimisation hack for exceptional compound ’seitsemäsneljästtä’ that inflects in all parts with agreement
NUM_51seitsemäsnoniljardis	Optimisation hack for exceptional compound ’seitsemäsnoniljardis’ that inflects in all parts with agreement
NUM_51seitsemäsnoniljoonas	Optimisation hack for exceptional compound ’seitsemäsnoniljoonas’ that inflects in all parts with agreement
NUM_51seitsemäsoktiljardis	Optimisation hack for exceptional compound ’seitsemäsoktiljardis’ that inflects in all parts with agreement
NUM_51seitsemäsoktiljoonas	Optimisation hack for exceptional compound ’seitsemäsoktiljoonas’ that inflects in all parts with agreement
NUM_51seitsemäspiljardis	Optimisation hack for exceptional compound ’seitsemäspiljardis’ that inflects in all parts with agreement
NUM_51seitsemäspiljoonas	Optimisation hack for exceptional compound ’seitsemäspiljoonas’ that inflects in all parts with agreement
NUM_51seitsemässadas	Optimisation hack for exceptional compound ’seitsemässadas’ that inflects in all parts with agreement
NUM_51seitsemässeitsemättä	Optimisation hack for exceptional compound ’seitsemässeitsemättä’ that inflects in all parts with agreement
NUM_51seitsemässentiljardis	Optimisation hack for exceptional compound ’seitsemässentiljardis’ that inflects in all parts with agreement
NUM_51seitsemässentiljoonas	Optimisation hack for exceptional compound ’seitsemässentiljoonas’ that inflects in all parts with agreement
NUM_51seitsemässeptiljardis	Optimisation hack for exceptional compound ’seitsemässeptiljardis’ that inflects in all parts with agreement
NUM_51seitsemässeptiljoonas	Optimisation hack for exceptional compound ’seitsemässeptiljoonas’ that inflects in all parts with agreement
NUM_51seitsemästoista	Optimisation hack for exceptional compound ’seitsemästoista’ that inflects in all parts with agreement
NUM_51seitsemästredekiljardis	Optimisation hack for exceptional compound ’seitsemästredekiljardis’ that inflects in all parts with agreement
NUM_51seitsemästredekiljoonas	Optimisation hack for exceptional compound ’seitsemästredekiljoonas’ that inflects in all parts with agreement
NUM_51seitsemästriljardis	Optimisation hack for exceptional compound ’seitsemästriljardis’ that inflects in all parts with agreement
NUM_51seitsemästriljoonas	Optimisation hack for exceptional compound ’seitsemästriljoonas’ that inflects in all parts with agreement
NUM_51seitsemästsiljardis	Optimisation hack for exceptional compound ’seitsemästsiljardis’ that inflects in all parts with agreement
NUM_51seitsemästsiljoonas	Optimisation hack for exceptional compound ’seitsemästsiljoonas’ that inflects in all parts with agreement
NUM_51seitsemästuhannes	Optimisation hack for exceptional compound ’seitsemästuhannes’ that inflects in all parts with agreement
NUM_51seitsemäsundekiljardis	Optimisation hack for exceptional compound ’seitsemäsundekiljardis’ that inflects in all parts with agreement
NUM_51seitsemäsundekiljoonas	Optimisation hack for exceptional compound ’seitsemäsundekiljoonas’ that inflects in all parts with agreement
NUM_51seitsemäsviidettä	Optimisation hack for exceptional compound ’seitsemäsviidettä’ that inflects in all parts with agreement
NUM_51seitsemäsyhdeksättä	Optimisation hack for exceptional compound ’seitsemäsyhdeksättä’ that inflects in all parts with agreement
NUM_51viidesbiljardis	Optimisation hack for exceptional compound ’viidesbiljardis’ that inflects in all parts with agreement
NUM_51viidesbiljoonas	Optimisation hack for exceptional compound ’viidesbiljoonas’ that inflects in all parts with agreement
NUM_51viidesdekiljardis	Optimisation hack for exceptional compound ’viidesdekiljardis’ that inflects in all parts with agreement
NUM_51viidesdekiljoonas	Optimisation hack for exceptional compound ’viidesdekiljoonas’ that inflects in all parts with agreement
NUM_51viidesduodekiljardis	Optimisation hack for exceptional compound ’viidesduodekiljardis’ that inflects in all parts with agreement
NUM_51viidesduodekiljoonas	Optimisation hack for exceptional compound ’viidesduodekiljoonas’ that inflects in all parts with agreement
NUM_51viideskahdeksatta	Optimisation hack for exceptional compound ’viideskahdeksatta’ that inflects in all parts with agreement
NUM_51viideskiljardis	Optimisation hack for exceptional compound ’viideskiljardis’ that inflects in all parts with agreement
NUM_51viideskiljoonas	Optimisation hack for exceptional compound ’viideskiljoonas’ that inflects in all parts with agreement
NUM_51viideskolmatta	Optimisation hack for exceptional compound ’viideskolmatta’ that inflects in all parts with agreement
NUM_51viideskuudetta	Optimisation hack for exceptional compound ’viideskuudetta’ that inflects in all parts with agreement
NUM_51viideskvadriljardis	Optimisation hack for exceptional compound ’viideskvadriljardis’ that inflects in all parts with agreement
NUM_51viideskvadriljoonas	Optimisation hack for exceptional compound ’viideskvadriljoonas’ that inflects in all parts with agreement
NUM_51viideskvintiljardis	Optimisation hack for exceptional compound ’viideskvintiljardis’ that inflects in all parts with agreement
NUM_51viideskvintiljoonas	Optimisation hack for exceptional compound ’viideskvintiljoonas’ that inflects in all parts with agreement
NUM_51viideskymmenes	Optimisation hack for exceptional compound ’viideskymmenes’ that inflects in all parts with agreement
NUM_51viidesmiljardis	Optimisation hack for exceptional compound ’viidesmiljardis’ that inflects in all parts with agreement
NUM_51viidesmiljoonas	Optimisation hack for exceptional compound ’viidesmiljoonas’ that inflects in all parts with agreement
NUM_51viidesneljästtä	Optimisation hack for exceptional compound ’viidesneljästtä’ that inflects in all parts with agreement
NUM_51viidesnoniljardis	Optimisation hack for exceptional compound ’viidesnoniljardis’ that inflects in all parts with agreement
NUM_51viidesnoniljoonas	Optimisation hack for exceptional compound ’viidesnoniljoonas’ that inflects in all parts with agreement
NUM_51viidesoktiljardis	Optimisation hack for exceptional compound ’viidesoktiljardis’ that inflects in all parts with agreement
NUM_51viidesoktiljoonas	Optimisation hack for exceptional compound ’viidesoktiljoonas’ that inflects in all parts with agreement
NUM_51viidespiljardis	Optimisation hack for exceptional compound ’viidespiljardis’ that inflects in all parts with agreement
NUM_51viidespiljoonas	Optimisation hack for exceptional compound ’viidespiljoonas’ that inflects in all parts with agreement
NUM_51viidessadas	Optimisation hack for exceptional compound ’viidessadas’ that inflects in all parts with agreement
NUM_51viidesseitsemättä	Optimisation hack for exceptional compound ’viidesseitsemättä’ that inflects in all parts with agreement
NUM_51viidessentiljardis	Optimisation hack for exceptional compound ’viidessentiljardis’ that inflects in all parts with agreement
NUM_51viidessentiljoonas	Optimisation hack for exceptional compound ’viidessentiljoonas’ that inflects in all parts with agreement
NUM_51viidesseptiljardis	Optimisation hack for exceptional compound ’viidesseptiljardis’ that inflects in all parts with agreement
NUM_51viidesseptiljoonas	Optimisation hack for exceptional compound ’viidesseptiljoonas’ that inflects in all parts with agreement
NUM_51viidestoista	Optimisation hack for exceptional compound ’viidestoista’ that inflects in all parts with agreement
NUM_51viidestredekiljardis	Optimisation hack for exceptional compound ’viidestredekiljardis’ that inflects in all parts with agreement
NUM_51viidestredekiljoonas	Optimisation hack for exceptional compound ’viidestredekiljoonas’ that inflects in all parts with agreement
NUM_51viidestriljardis	Optimisation hack for exceptional compound ’viidestriljardis’ that inflects in all parts with agreement
NUM_51viidestriljoonas	Optimisation hack for exceptional compound ’viidestriljoonas’ that inflects in all parts with agreement
NUM_51viidestsiljardis	Optimisation hack for exceptional compound ’viidestsiljardis’ that inflects in all parts with agreement
NUM_51viidestsiljoonas	Optimisation hack for exceptional compound ’viidestsiljoonas’ that inflects in all parts with agreement
NUM_51viidestuhannes	Optimisation hack for exceptional compound ’viidestuhannes’ that inflects in all parts with agreement
NUM_51viidesundekiljardis	Optimisation hack for exceptional compound ’viidesundekiljardis’ that inflects in all parts with agreement
NUM_51viidesundekiljoonas	Optimisation hack for exceptional compound ’viidesundekiljoonas’ that inflects in all parts with agreement
NUM_51viidesviidettä	Optimisation hack for exceptional compound ’viidesviidettä’ that inflects in all parts with agreement
NUM_51viidesyhdeksättä	Optimisation hack for exceptional compound ’viidesyhdeksättä’ that inflects in all parts with agreement
NUM_51viisibiljardia	Optimisation hack for exceptional compound ’viisibiljardia’ that inflects in all parts with agreement
NUM_51viisibiljoonaa	Optimisation hack for exceptional compound ’viisibiljoonaa’ that inflects in all parts with agreement
NUM_51viisidekiljardia	Optimisation hack for exceptional compound ’viisidekiljardia’ that inflects in all parts with agreement
NUM_51viisidekiljoonaa	Optimisation hack for exceptional compound ’viisidekiljoonaa’ that inflects in all parts with agreement
NUM_51viisiduodekiljardia	Optimisation hack for exceptional compound ’viisiduodekiljardia’ that inflects in all parts with agreement
NUM_51viisiduodekiljoonaa	Optimisation hack for exceptional compound ’viisiduodekiljoonaa’ that inflects in all parts with agreement
NUM_51viisikahdeksatta	Optimisation hack for exceptional compound ’viisikahdeksatta’ that inflects in all parts with agreement
NUM_51viisikiljardia	Optimisation hack for exceptional compound ’viisikiljardia’ that inflects in all parts with agreement
NUM_51viisikiljoonaa	Optimisation hack for exceptional compound ’viisikiljoonaa’ that inflects in all parts with agreement
NUM_51viisikolmatta	Optimisation hack for exceptional compound ’viisikolmatta’ that inflects in all parts with agreement
NUM_51viisikuudetta	Optimisation hack for exceptional compound ’viisikuudetta’ that inflects in all parts with agreement
NUM_51viisikvadriljardia	Optimisation hack for exceptional compound ’viisikvadriljardia’ that inflects in all parts with agreement
NUM_51viisikvadriljoonaa	Optimisation hack for exceptional compound ’viisikvadriljoonaa’ that inflects in all parts with agreement
NUM_51viisikvintiljardia	Optimisation hack for exceptional compound ’viisikvintiljardia’ that inflects in all parts with agreement
NUM_51viisikvintiljoonaa	Optimisation hack for exceptional compound ’viisikvintiljoonaa’ that inflects in all parts with agreement
NUM_51viisikymmentä	Optimisation hack for exceptional compound ’viisikymmentä’ that inflects in all parts with agreement
NUM_51viisimiljardia	Optimisation hack for exceptional compound ’viisimiljardia’ that inflects in all parts with agreement
NUM_51viisimiljoonaa	Optimisation hack for exceptional compound ’viisimiljoonaa’ that inflects in all parts with agreement
NUM_51viisineljättä	Optimisation hack for exceptional compound ’viisineljättä’ that inflects in all parts with agreement
NUM_51viisinoniljardia	Optimisation hack for exceptional compound ’viisinoniljardia’ that inflects in all parts with agreement
NUM_51viisinoniljoonaa	Optimisation hack for exceptional compound ’viisinoniljoonaa’ that inflects in all parts with agreement
NUM_51viisioktiljardia	Optimisation hack for exceptional compound ’viisioktiljardia’ that inflects in all parts with agreement
NUM_51viisioktiljoonaa	Optimisation hack for exceptional compound ’viisioktiljoonaa’ that inflects in all parts with agreement
NUM_51viisipiljardia	Optimisation hack for exceptional compound ’viisipiljardia’ that inflects in all parts with agreement
NUM_51viisipiljoonaa	Optimisation hack for exceptional compound ’viisipiljoonaa’ that inflects in all parts with agreement
NUM_51viisisataa	Optimisation hack for exceptional compound ’viisisataa’ that inflects in all parts with agreement
NUM_51viisiseitsemättä	Optimisation hack for exceptional compound ’viisiseitsemättä’ that inflects in all parts with agreement
NUM_51viisisentiljardia	Optimisation hack for exceptional compound ’viisisentiljardia’ that inflects in all parts with agreement
NUM_51viisisentiljoonaa	Optimisation hack for exceptional compound ’viisisentiljoonaa’ that inflects in all parts with agreement
NUM_51viisiseptiljardia	Optimisation hack for exceptional compound ’viisiseptiljardia’ that inflects in all parts with agreement
NUM_51viisiseptiljoonaa	Optimisation hack for exceptional compound ’viisiseptiljoonaa’ that inflects in all parts with agreement
NUM_51viisitoista	Optimisation hack for exceptional compound ’viisitoista’ that inflects in all parts with agreement
NUM_51viisitredekiljardia	Optimisation hack for exceptional compound ’viisitredekiljardia’ that inflects in all parts with agreement
NUM_51viisitredekiljoonaa	Optimisation hack for exceptional compound ’viisitredekiljoonaa’ that inflects in all parts with agreement
NUM_51viisitriljardia	Optimisation hack for exceptional compound ’viisitriljardia’ that inflects in all parts with agreement
NUM_51viisitriljoonaa	Optimisation hack for exceptional compound ’viisitriljoonaa’ that inflects in all parts with agreement
NUM_51viisitsiljardia	Optimisation hack for exceptional compound ’viisitsiljardia’ that inflects in all parts with agreement
NUM_51viisitsiljoonaa	Optimisation hack for exceptional compound ’viisitsiljoonaa’ that inflects in all parts with agreement
NUM_51viisituhatta	Optimisation hack for exceptional compound ’viisituhatta’ that inflects in all parts with agreement
NUM_51viisiundekiljardia	Optimisation hack for exceptional compound ’viisiundekiljardia’ that inflects in all parts with agreement
NUM_51viisiundekiljoonaa	Optimisation hack for exceptional compound ’viisiundekiljoonaa’ that inflects in all parts with agreement
NUM_51viisiviidettä	Optimisation hack for exceptional compound ’viisiviidettä’ that inflects in all parts with agreement
NUM_51viisiyhdeksättä	Optimisation hack for exceptional compound ’viisiyhdeksättä’ that inflects in all parts with agreement
NUM_51yhdeksänbiljardia	Optimisation hack for exceptional compound ’yhdeksänbiljardia’ that inflects in all parts with agreement
NUM_51yhdeksänbiljoonaa	Optimisation hack for exceptional compound ’yhdeksänbiljoonaa’ that inflects in all parts with agreement
NUM_51yhdeksändekiljardia	Optimisation hack for exceptional compound ’yhdeksändekiljardia’ that inflects in all parts with agreement
NUM_51yhdeksändekiljoonaa	Optimisation hack for exceptional compound ’yhdeksändekiljoonaa’ that inflects in all parts with agreement
NUM_51yhdeksänduodekiljardia	Optimisation hack for exceptional compound ’yhdeksänduodekiljardia’ that inflects in all parts with agreement
NUM_51yhdeksänduodekiljoonaa	Optimisation hack for exceptional compound ’yhdeksänduodekiljoonaa’ that inflects in all parts with agreement
NUM_51yhdeksänkahdeksatta	Optimisation hack for exceptional compound ’yhdeksänkahdeksatta’ that inflects in all parts with agreement
NUM_51yhdeksänkiljardia	Optimisation hack for exceptional compound ’yhdeksänkiljardia’ that inflects in all parts with agreement
NUM_51yhdeksänkiljoonaa	Optimisation hack for exceptional compound ’yhdeksänkiljoonaa’ that inflects in all parts with agreement
NUM_51yhdeksänkolmatta	Optimisation hack for exceptional compound ’yhdeksänkolmatta’ that inflects in all parts with agreement
NUM_51yhdeksänkuudetta	Optimisation hack for exceptional compound ’yhdeksänkuudetta’ that inflects in all parts with agreement
NUM_51yhdeksänkvadriljardia	Optimisation hack for exceptional compound ’yhdeksänkvadriljardia’ that inflects in all parts with agreement
NUM_51yhdeksänkvadriljoonaa	Optimisation hack for exceptional compound ’yhdeksänkvadriljoonaa’ that inflects in all parts with agreement
NUM_51yhdeksänkvintiljardia	Optimisation hack for exceptional compound ’yhdeksänkvintiljardia’ that inflects in all parts with agreement
NUM_51yhdeksänkvintiljoonaa	Optimisation hack for exceptional compound ’yhdeksänkvintiljoonaa’ that inflects in all parts with agreement
NUM_51yhdeksänkymmentä	Optimisation hack for exceptional compound ’yhdeksänkymmentä’ that inflects in all parts with agreement
NUM_51yhdeksänmiljardia	Optimisation hack for exceptional compound ’yhdeksänmiljardia’ that inflects in all parts with agreement
NUM_51yhdeksänmiljoonaa	Optimisation hack for exceptional compound ’yhdeksänmiljoonaa’ that inflects in all parts with agreement
NUM_51yhdeksänneljättä	Optimisation hack for exceptional compound ’yhdeksänneljättä’ that inflects in all parts with agreement
NUM_51yhdeksännoniljardia	Optimisation hack for exceptional compound ’yhdeksännoniljardia’ that inflects in all parts with agreement
NUM_51yhdeksännoniljoonaa	Optimisation hack for exceptional compound ’yhdeksännoniljoonaa’ that inflects in all parts with agreement
NUM_51yhdeksänoktiljardia	Optimisation hack for exceptional compound ’yhdeksänoktiljardia’ that inflects in all parts with agreement
NUM_51yhdeksänoktiljoonaa	Optimisation hack for exceptional compound ’yhdeksänoktiljoonaa’ that inflects in all parts with agreement
NUM_51yhdeksänpiljardia	Optimisation hack for exceptional compound ’yhdeksänpiljardia’ that inflects in all parts with agreement
NUM_51yhdeksänpiljoonaa	Optimisation hack for exceptional compound ’yhdeksänpiljoonaa’ that inflects in all parts with agreement
NUM_51yhdeksänsataa	Optimisation hack for exceptional compound ’yhdeksänsataa’ that inflects in all parts with agreement
NUM_51yhdeksänseitsemättä	Optimisation hack for exceptional compound ’yhdeksänseitsemättä’ that inflects in all parts with agreement
NUM_51yhdeksänsentiljardia	Optimisation hack for exceptional compound ’yhdeksänsentiljardia’ that inflects in all parts with agreement
NUM_51yhdeksänsentiljoonaa	Optimisation hack for exceptional compound ’yhdeksänsentiljoonaa’ that inflects in all parts with agreement
NUM_51yhdeksänseptiljardia	Optimisation hack for exceptional compound ’yhdeksänseptiljardia’ that inflects in all parts with agreement
NUM_51yhdeksänseptiljoonaa	Optimisation hack for exceptional compound ’yhdeksänseptiljoonaa’ that inflects in all parts with agreement
NUM_51yhdeksäntoista	Optimisation hack for exceptional compound ’yhdeksäntoista’ that inflects in all parts with agreement
NUM_51yhdeksäntredekiljardia	Optimisation hack for exceptional compound ’yhdeksäntredekiljardia’ that inflects in all parts with agreement
NUM_51yhdeksäntredekiljoonaa	Optimisation hack for exceptional compound ’yhdeksäntredekiljoonaa’ that inflects in all parts with agreement
NUM_51yhdeksäntriljardia	Optimisation hack for exceptional compound ’yhdeksäntriljardia’ that inflects in all parts with agreement
NUM_51yhdeksäntriljoonaa	Optimisation hack for exceptional compound ’yhdeksäntriljoonaa’ that inflects in all parts with agreement
NUM_51yhdeksäntsiljardia	Optimisation hack for exceptional compound ’yhdeksäntsiljardia’ that inflects in all parts with agreement
NUM_51yhdeksäntsiljoonaa	Optimisation hack for exceptional compound ’yhdeksäntsiljoonaa’ that inflects in all parts with agreement
NUM_51yhdeksäntuhatta	Optimisation hack for exceptional compound ’yhdeksäntuhatta’ that inflects in all parts with agreement
NUM_51yhdeksänundekiljardia	Optimisation hack for exceptional compound ’yhdeksänundekiljardia’ that inflects in all parts with agreement
NUM_51yhdeksänundekiljoonaa	Optimisation hack for exceptional compound ’yhdeksänundekiljoonaa’ that inflects in all parts with agreement
NUM_51yhdeksänviidettä	Optimisation hack for exceptional compound ’yhdeksänviidettä’ that inflects in all parts with agreement
NUM_51yhdeksänyhdeksättä	Optimisation hack for exceptional compound ’yhdeksänyhdeksättä’ that inflects in all parts with agreement
NUM_51yhdeksäsbiljardis	Optimisation hack for exceptional compound ’yhdeksäsbiljardis’ that inflects in all parts with agreement
NUM_51yhdeksäsbiljoonas	Optimisation hack for exceptional compound ’yhdeksäsbiljoonas’ that inflects in all parts with agreement
NUM_51yhdeksäsdekiljardis	Optimisation hack for exceptional compound ’yhdeksäsdekiljardis’ that inflects in all parts with agreement
NUM_51yhdeksäsdekiljoonas	Optimisation hack for exceptional compound ’yhdeksäsdekiljoonas’ that inflects in all parts with agreement
NUM_51yhdeksäsduodekiljardis	Optimisation hack for exceptional compound ’yhdeksäsduodekiljardis’ that inflects in all parts with agreement
NUM_51yhdeksäsduodekiljoonas	Optimisation hack for exceptional compound ’yhdeksäsduodekiljoonas’ that inflects in all parts with agreement
NUM_51yhdeksäskahdeksatta	Optimisation hack for exceptional compound ’yhdeksäskahdeksatta’ that inflects in all parts with agreement
NUM_51yhdeksäskiljardis	Optimisation hack for exceptional compound ’yhdeksäskiljardis’ that inflects in all parts with agreement
NUM_51yhdeksäskiljoonas	Optimisation hack for exceptional compound ’yhdeksäskiljoonas’ that inflects in all parts with agreement
NUM_51yhdeksäskolmatta	Optimisation hack for exceptional compound ’yhdeksäskolmatta’ that inflects in all parts with agreement
NUM_51yhdeksäskuudetta	Optimisation hack for exceptional compound ’yhdeksäskuudetta’ that inflects in all parts with agreement
NUM_51yhdeksäskvadriljardis	Optimisation hack for exceptional compound ’yhdeksäskvadriljardis’ that inflects in all parts with agreement
NUM_51yhdeksäskvadriljoonas	Optimisation hack for exceptional compound ’yhdeksäskvadriljoonas’ that inflects in all parts with agreement
NUM_51yhdeksäskvintiljardis	Optimisation hack for exceptional compound ’yhdeksäskvintiljardis’ that inflects in all parts with agreement
NUM_51yhdeksäskvintiljoonas	Optimisation hack for exceptional compound ’yhdeksäskvintiljoonas’ that inflects in all parts with agreement
NUM_51yhdeksäskymmenes	Optimisation hack for exceptional compound ’yhdeksäskymmenes’ that inflects in all parts with agreement
NUM_51yhdeksäsmiljardis	Optimisation hack for exceptional compound ’yhdeksäsmiljardis’ that inflects in all parts with agreement
NUM_51yhdeksäsmiljoonas	Optimisation hack for exceptional compound ’yhdeksäsmiljoonas’ that inflects in all parts with agreement
NUM_51yhdeksäsneljästtä	Optimisation hack for exceptional compound ’yhdeksäsneljästtä’ that inflects in all parts with agreement
NUM_51yhdeksäsnoniljardis	Optimisation hack for exceptional compound ’yhdeksäsnoniljardis’ that inflects in all parts with agreement
NUM_51yhdeksäsnoniljoonas	Optimisation hack for exceptional compound ’yhdeksäsnoniljoonas’ that inflects in all parts with agreement
NUM_51yhdeksäsoktiljardis	Optimisation hack for exceptional compound ’yhdeksäsoktiljardis’ that inflects in all parts with agreement
NUM_51yhdeksäsoktiljoonas	Optimisation hack for exceptional compound ’yhdeksäsoktiljoonas’ that inflects in all parts with agreement
NUM_51yhdeksäspiljardis	Optimisation hack for exceptional compound ’yhdeksäspiljardis’ that inflects in all parts with agreement
NUM_51yhdeksäspiljoonas	Optimisation hack for exceptional compound ’yhdeksäspiljoonas’ that inflects in all parts with agreement
NUM_51yhdeksässadas	Optimisation hack for exceptional compound ’yhdeksässadas’ that inflects in all parts with agreement
NUM_51yhdeksässeitsemättä	Optimisation hack for exceptional compound ’yhdeksässeitsemättä’ that inflects in all parts with agreement
NUM_51yhdeksässentiljardis	Optimisation hack for exceptional compound ’yhdeksässentiljardis’ that inflects in all parts with agreement
NUM_51yhdeksässentiljoonas	Optimisation hack for exceptional compound ’yhdeksässentiljoonas’ that inflects in all parts with agreement
NUM_51yhdeksässeptiljardis	Optimisation hack for exceptional compound ’yhdeksässeptiljardis’ that inflects in all parts with agreement
NUM_51yhdeksässeptiljoonas	Optimisation hack for exceptional compound ’yhdeksässeptiljoonas’ that inflects in all parts with agreement
NUM_51yhdeksästoista	Optimisation hack for exceptional compound ’yhdeksästoista’ that inflects in all parts with agreement
NUM_51yhdeksästredekiljardis	Optimisation hack for exceptional compound ’yhdeksästredekiljardis’ that inflects in all parts with agreement
NUM_51yhdeksästredekiljoonas	Optimisation hack for exceptional compound ’yhdeksästredekiljoonas’ that inflects in all parts with agreement
NUM_51yhdeksästriljardis	Optimisation hack for exceptional compound ’yhdeksästriljardis’ that inflects in all parts with agreement
NUM_51yhdeksästriljoonas	Optimisation hack for exceptional compound ’yhdeksästriljoonas’ that inflects in all parts with agreement
NUM_51yhdeksästsiljardis	Optimisation hack for exceptional compound ’yhdeksästsiljardis’ that inflects in all parts with agreement
NUM_51yhdeksästsiljoonas	Optimisation hack for exceptional compound ’yhdeksästsiljoonas’ that inflects in all parts with agreement
NUM_51yhdeksästuhannes	Optimisation hack for exceptional compound ’yhdeksästuhannes’ that inflects in all parts with agreement
NUM_51yhdeksäsundekiljardis	Optimisation hack for exceptional compound ’yhdeksäsundekiljardis’ that inflects in all parts with agreement
NUM_51yhdeksäsundekiljoonas	Optimisation hack for exceptional compound ’yhdeksäsundekiljoonas’ that inflects in all parts with agreement
NUM_51yhdeksäsviidettä	Optimisation hack for exceptional compound ’yhdeksäsviidettä’ that inflects in all parts with agreement
NUM_51yhdeksäsyhdeksättä	Optimisation hack for exceptional compound ’yhdeksäsyhdeksättä’ that inflects in all parts with agreement
NUM_51yhdeskahdeksatta	Optimisation hack for exceptional compound ’yhdeskahdeksatta’ that inflects in all parts with agreement
NUM_51yhdeskolmatta	Optimisation hack for exceptional compound ’yhdeskolmatta’ that inflects in all parts with agreement
NUM_51yhdeskuudetta	Optimisation hack for exceptional compound ’yhdeskuudetta’ that inflects in all parts with agreement
NUM_51yhdesneljästtä	Optimisation hack for exceptional compound ’yhdesneljästtä’ that inflects in all parts with agreement
NUM_51yhdesseitsemättä	Optimisation hack for exceptional compound ’yhdesseitsemättä’ that inflects in all parts with agreement
NUM_51yhdestoista	Optimisation hack for exceptional compound ’yhdestoista’ that inflects in all parts with agreement
NUM_51yhdesviidettä	Optimisation hack for exceptional compound ’yhdesviidettä’ that inflects in all parts with agreement
NUM_51yhdesyhdeksättä	Optimisation hack for exceptional compound ’yhdesyhdeksättä’ that inflects in all parts with agreement
NUM_51yksikahdeksatta	Optimisation hack for exceptional compound ’yksikahdeksatta’ that inflects in all parts with agreement
NUM_51yksikolmatta	Optimisation hack for exceptional compound ’yksikolmatta’ that inflects in all parts with agreement
NUM_51yksikuudetta	Optimisation hack for exceptional compound ’yksikuudetta’ that inflects in all parts with agreement
NUM_51yksineljättä	Optimisation hack for exceptional compound ’yksineljättä’ that inflects in all parts with agreement
NUM_51yksiseitsemättä	Optimisation hack for exceptional compound ’yksiseitsemättä’ that inflects in all parts with agreement
NUM_51yksitoista	Optimisation hack for exceptional compound ’yksitoista’ that inflects in all parts with agreement
NUM_51yksiviidettä	Optimisation hack for exceptional compound ’yksiviidettä’ that inflects in all parts with agreement
NUM_51yksiyhdeksättä	Optimisation hack for exceptional compound ’yksiyhdeksättä’ that inflects in all parts with agreement
NUM_ENSIMMÄINEN	Dictionary class38
NUM_KAHDEKSAN	Dictionary class10n
NUM_KAKSI	Dictionary class31 back§
NUM_KOLMAS	Dictionary class45
NUM_KOLMASOSA	Numerals for parts ‛-osa’ inflect like NOUN_ASEMA
NUM_KOLME	Dictionary class8~5
NUM_KUUSI	Dictionary class27 back
NUM_KUUTISEN	Approximative numerals, back suffixes, compounding with select multipliers
NUM_KYMMEN	archaic form ‘kymmen’ inflects like NUM_KYMMENEN
NUM_KYMMENEN	Dictionary class32
NUM_KYMMENKUNTA	Approximative numerals, no inflection
NUM_KYMMENTÄ	bound numeral multiplier
NUM_MILJARDI	Dictionary class5
NUM_MILJOONA	Dictionary class10
NUM_NELJÄ	Dictionary class10
NUM_NELJÄS	Dictionary class45 fron
NUM_PARI	Dictionary class5 moremore
NUM_PUOLI	numeral puoli inflects like
NUM_SATA	Dictionary class9
NUM_TOINEN	Dictionary class38 back
NUM_TUHAT	Dictionary class46
NUM_VIISI	Dictionary class27 front
NUM_VIITISEN	Approximative numerals, front suffixes, compounding with select multipliers
NUM_YHDEKSÄN	Dictionary class10n front
NUM_YKSI	Dictionary class31
PRON_AINOA	non-inflectin pronuns with optional possessive suffixes, back
PRON_ERÄS	pronoun s:ä inflection like NOUN_XXX
PRON_HÄN	personal pronoun ‘hän’ inflects with e stem, singular only
PRON_HÄÄ	dialectal forms of hän
PRON_IKINEN	pronouns inen inflect like NOUN_AAKKOSTAMINEN
PRON_ITSE	inflects like NOUN_xxE
PRON_JOKA	pronoun joka inflects from jo stem with optionally ka clitic for most forms
PRON_JOKAINEN	inflects like NOUN_JOKAINEN
PRON_JOKIN	pronoun jokin, mikin inflect before kin clitic
PRON_JOKU	pronoun joku inflects with agreement like compound 51 jo+ku
PRON_JOMPIKUMPI	pronoun jompikumpi inflects with agreement like compound 51 jompi+kumpi c.f. PRON_KUMPI
PRON_KAIKKI	prnoun kaikki inflects like NOUN_
PRON_KOKO	pronouns without inflections or even clitics
PRON_KUKA	pronoun kuka has heteroclitic ke stem for inflection as well as more rare or diaectal ku- etc.
PRON_KUKAAN	pronoun kukaan inflects like PRON_KUKA before kaan clitic
PRON_KUKAKIN	pronoun kukakin inflects like PRON_KUKAKIN before kin clitic
PRON_KUKIN	pronoun kukin inflects before kin clitic with only ku stem
PRON_KUMPI	pronoun kumpi inflects like comparatives, see NOUN_VANHEMPI
PRON_KUMPIKAAN	pronoun kumpikaan inflects like PRON_KUMPI before kaan clitic
PRON_KUMPIKIN	pronoun kumpikaan inflects like PRON_KUMPI before kin clitic
PRON_MA	dialectal forms of minä
PRON_ME	personal pronouns ‘me, te, he’ inflect with e stems, plural only
PRON_MIE	dialectal forms of minä, inflects with u stem
PRON_MIKIN	no inflection?
PRON_MIKÄ	pronoun mikä inflects from mi- stem
PRON_MIKÄKIN	pronoun mikäkin does not inflects
PRON_MIKÄÄN	pronoun mikään inflects with mi- stem and clitic kään
PRON_MINÄ	personal pronouns ‘minä, sinä’ inflect with u stem, singular nly
PRON_MOLEMMAT	does not inflect more than clitics
PRON_MONES	inflects like NUM_KOLMAS
PRON_MONI	i:e inflects like
PRON_MONIAS	as:aa archaic, inflects like ADJ_AUTUAS
PRON_MONTA	accounts special monta:montaa inflections
PRON_MONTAKO	partitive with clitic lexicalised, no inflections
PRON_MUU	inflects NOUN_PUU
PRON_MUUAN	no inflects
PRON_MUUTAMA	inflects like NOUN_ASEMA
PRON_MÄ	dialectal forms of minä
PRON_MÄÄ	dialectal forms of minä
PRON_NE	inflects with e:i stems, plurals only
PRON_NOI	dialectal forms of nuo
PRON_NUO	inflects like NOUN_SUO, plurals only
PRON_NÄMÄ	inflects with ä stem, plurals only
PRON_SAMA	inflects like NOUN_OMENA
PRON_SE	inflects with e:i stems, singulars only
PRON_TOI	dialectal forms of nuo
PRON_TOINEN	inflects like NUM_TOINEN
PRON_TUO	inflects like NOUN_SUO, singulars only
PRON_TÄMÄ	inflects with ä stem, singulars only
PRON_USEA	a:0 inflects like ADJ_xxEA
PRON_USEAMPI	inflects like NOUN_VANHEMPI
PRON_USEIMMAT	partially inflects like NOUN_VANHIN
PRON_YKSI	inflects like NUM_YKSI
PROPN_51Iso-Britannia	Optimisation hack for exceptional compound ’Iso-Britannia’ that inflects in all parts with agreement
PROPN_51Mustameri	Optimisation hack for exceptional compound ’Mustameri’ that inflects in all parts with agreement
PROPN_51Punainenmeri	Optimisation hack for exceptional compound ’Punainenmeri’ that inflects in all parts with agreement
PROPN_51Tyynimeri	Optimisation hack for exceptional compound ’Tyynimeri’ that inflects in all parts with agreement
PROPN_51Uusikaupunki	Optimisation hack for exceptional compound ’Uusikaupunki’ that inflects in all parts with agreement
PROPN_51Uusimaa	Optimisation hack for exceptional compound ’Uusimaa’ that inflects in all parts with agreement
PROPN_51Uusi-Seelanti	Optimisation hack for exceptional compound ’Uusi-Seelanti’ that inflects in all parts with agreement
PROPN_A.	Middle initials don't inflect or compound
PROPN_AAKKOSELLISUUS	inflects like NOUN_AAKKOSELLISUUS Dictionary class 40 back
PROPN_AAKKOSTAMINEN	Dictionary class 38 back
PROPN_AALLOT	Dictionary class 1lot plurale tantum
PROPN_AARRE	Dictionary class 48 back re
PROPN_ACRO_AA	acronyms ending in 'a' pronounced as a letter
PROPN_ACRO_DOLLARI	The acronyms ending in a word that inflects like ‘dollari’ with i:e type stem
PROPN_ACRO_EE	acronyms ending in 'b', 'c', 'd', 'e', 'g', 'p', 'v', 'w' or 't' pronounced as a letter
PROPN_ACRO_GRAMMA	The acronyms ending in a word that inflects like ‘gramma’ with a:o type stem
PROPN_ACRO_II	Acronyms that end in 'j' or 'i' pronoynced as letter
PROPN_ACRO_JÄRJESTÖ	The acronyms ending in a word that inflects like ‘järjestö’ with ö type stem
PROPN_ACRO_KAHDEKSAN	Proper noun acronyms ending in 8
PROPN_ACRO_KAKSI	Proper noun acronyms ending in 2
PROPN_ACRO_KANDELA	The acronyms ending in a word that inflects like ‘kandela’ with a:0 type stem
PROPN_ACRO_KOLME	The acronyms ending in digit 3 pronounced as number
PROPN_ACRO_KUUSI	Proper noun acronyms ending in 6
PROPN_ACRO_LEHTI	The acronyms ending in a word that inflects like ‘lehti’ with i:e type stem
PROPN_ACRO_METRI	The acronyms ending in a word that inflects like ‘metri’ with i:e type stem
PROPN_ACRO_NELJÄ	Proper noun acronyms ending in 4
PROPN_ACRO_NOLLA	The acronyms ending in digit 0 pronounced as a number
PROPN_ACRO_OO	Acronyms that end in 'h', 'k' or 'o' that is pronounced as a letter
PROPN_ACRO_PUNTA	The acronyms ending in a word that inflects like ‘punta’ with a:0 type stem
PROPN_ACRO_SEITSEMÄN	Proper noun acronyms ending in 7
PROPN_ACRO_UU	Acronyms that end in 'q', or 'u' pronounced as a letter
PROPN_ACRO_VIISI	The acronyms ending in digit 5 pronounced as number
PROPN_ACRO_WEBER	The acronyms ending in a word that inflects like ‘weber’ with r:re type stem
PROPN_ACRO_YHDEKSÄN	Proper noun acronyms ending in 9
PROPN_ACRO_YKSI	Proper noun acronyms ending in 1
PROPN_ACRO_YY	Acronym that ends in 'y' pronounced as letter
PROPN_ACRO_ZET	Acronyms that end in 'z' pronounced as letter
PROPN_ACRO_ÄKS	Acronym that ends in 'f', 'l', 'm', 'n', 'r', 's', 'š' or 'x' pronounced as a letter
PROPN_ACRO_ÖÖ	Acronyms that end in 'ö' pronounced as letter
PROPN_ACRO_Ω	Acronyms that end in ‘oomega’
PROPN_AHDET	some det final proper nouns have special variation:
PROPN_AIVOKUOLLUT	Dictionary class 47 back
PROPN_AIVOT	Dictionary class 1o plurale tantum
PROPN_AJATAR	Dictionary class 32 tar
PROPN_ALKU	Dictionary class 1ku with k:0
PROPN_ALLAS	Dictionary class 41 las
PROPN_ALTIS	Proper noun with is:ii variation, back harmony
PROPN_APE	Dictionary class 48 back pe
PROPN_APU	Dictionary class 1pu
PROPN_ARISTOTELES	Dictionary class 41 es back
PROPN_ARKI	Dictionary class 7 back k~j
PROPN_ASEMA	Dictionary class 11 back
PROPN_ASKAR	Dictionary class 49 ar
PROPN_ASTE	Dictionary class 48 back
PROPN_ASU	The stems ending in u are also without variationm and the bisyllabic ones have the same simple allomorph pattern: Dictionary class 1u
PROPN_ASUKAS	Dictionary class 41 kas
PROPN_ATERIMET	Dictionary class 31 t plurale tantum
PROPN_BÉBÉ	Dictionary class 21 e front
PROPN_BEIGNET	Dictionary class 22 e front
PROPN_BERNIE	This class includes a set of new proper nouns that get nativised a bit Dictionary class 3etä
PROPN_BESSERWISSER	Dictionary class 6 front no i
PROPN_BIDEE	Dictionary class 20 e front There’s a gap in -ii final loan stems.
PROPN_BIKINIT	Dictionary class xxx nit plurale tantum
PROPN_BORDEAUX	Dictionary class 22 o
PROPN_BRASSERIE	Dictionary class 21 i back
PROPN_BRIE	Dictionary class 21 i front
PROPN_BROOKLYN	Dictionary class 6 back no i with both vowel harmonies allowed
PROPN_CAMUS	Dictionary class 22 y
PROPN_CHACHACHA	Dictionary class 21 a The loan words that end in consonant when written but vowel when pronounced are inflected with an apostrophe ’. With half-vowels the rule is a bit shaky, but officially apostrophe is the only way.
PROPN_COMPOUND	for bound proper noun particles, usually with hyphen, such as ‘Etelä-’
PROPN_COWBOY	Dictionary class 21 iy
PROPN_DIMITRIS	Dictionary class 41 is front
PROPN_EKKE	Proper noun with kke:ke stem
PROPN_ELIN	Dictionary class 33 front
PROPN_ELÄMÄ	Dictionary class 11 front
PROPN_EPÄILTY	Dictionary class 1lty
PROPN_ESQUIMAU	Dictionary class 21 o back
PROPN_EUGENE	Proper noun with e stem and back harmony
PROPN_FARKUT	Dictionary class 1ku plurale tantum
PROPN_FARMARIT	Dictionary class xxx it plurale tantum
PROPN_FIFA	initialism treated like word inflecting like NOUN_OMENA
PROPN_FONDUE	Dictionary class 21 ye
PROPN_FÄNRIKIT	Plural-only proper noun with i:e stem and kk:k gradation
PROPN_GAY	Dictionary class 21 yi
PROPN_HAAKSI	Dictionary class 27 ksi
PROPN_HAI	Dictionary class 18 i back
PROPN_HAIT	Plural-only proper noun with monosyllabic ai stem
PROPN_HAMMAS	Dictionary class 41 mas
PROPN_HAPPI	Dictionary class 7 back p~0
PROPN_HAPPO	Dictionary class 1po
PROPN_HEITIN	Dictionary class 33 front tin
PROPN_HENKI	Dictionary class 7 front k~g
PROPN_HEPO	Dictionary class 1po
PROPN_HIIRI	Dictionary class 24 front It is noteworthy of the official dictionary classification, that classes with numbers 24 and 26 are identical. The distinction should probably not be retained in future versions.
PROPN_HIRTTO	Dictionary class 1to
PROPN_HIUTALEET	Dictionary class leat plurale tantum
PROPN_HONKA	Dictionary class 10 back k~g
PROPN_HOPEAT	Dictionary class xxx eat plurale tantum
PROPN_HORTA	Proper noun wita a:0 stem and rt:rr gradation
PROPN_HOUSUT	Dictionary class 1u plurale tantum
PROPN_HUOLITELTU	Dictionary class 1ltu
PROPN_HUPI	Dictionary class 5 back p~v There is a gap in i final words for p:v variation and front harmony
PROPN_HYLKY	Dictionary class 1ky
PROPN_HYÖTYY	Proper nouns with yy-stem
PROPN_HÄIRIÖ	Dictionary class 3ö
PROPN_HÄKKI	Dictionary class 5 front k~0
PROPN_HÄKKYRÄ	Dictionary class 12 front There is a possible class for further variation of a:o in the old dictionary dictionary that is worth re-evaluating. There’s one more allomorph pattern.
PROPN_HÄMET	Proper nouns with et-stem
PROPN_HÄMMINKI	Dictionary class 5 front k~g There is a gap in i final paradigm with t:l variation and back vowels.
PROPN_HÄNNÄT	Plural-only proper noun with ä:0 stem and nt:nn gradation
PROPN_HÄNTÄ	Dictionary class 10 front t~n
PROPN_HÄRKIN	Proper nouns with in:ime stems
PROPN_HÄÄT	Dictionary class xxx äät plurale tantum
PROPN_HÄÄTÖ	Dictionary class 1tö
PROPN_HÖLKKÄ	Dictionary class 10 front k̃~0
PROPN_HÖPÖTTÄJÄ	Dictionary class 10 front
PROPN_HÖYHENET	Dictionary class 32 t plurale tantum
PROPN_INGET	Plural-only proper noun with i:e stem and nk:ng gradation
PROPN_ITÄMAAT	Dictionary class xxx maat plurale tantum
PROPN_JEPPE	Dictionary class 8 p~0 front
PROPN_JOCKEY	Dictionary class 21 yi
PROPN_JOUKOT	Dictionary class 1ko plurale tantum
PROPN_JOUTSEN	Dictionary class 32 back
PROPN_JUHLAT	Dictionary class xxx t plurale tantum
PROPN_JUOVAT	proper noun inflects like NOUN_PROBLEEMAT
PROPN_JYLKYT	Plural-only proper noun with i:e stem and kk:k gradation
PROPN_JÄRJESTÖT	Plural-only proper noun with i:e stem and kk:k gradation
PROPN_JÄRKI	Dictionary class 7 front k~j
PROPN_JÄRVITAHDON	Proper nouns that look like Järvitahdon(?)
PROPN_JÄÄTELÖ	Dictionary class 2ö
PROPN_KAARET	Plural-only proper noun with i:e stem and kk:k gradation
PROPN_KAARRET	Plural-only proper noun with i:e stem and kk:k gradation
PROPN_KAARROT	Plural-only proper noun with i:e stem and kk:k gradation
PROPN_KALATOIN	Proper nouns that have old caritive toin stem
PROPN_KANAALI	Proper nouns that have i:e stems
PROPN_KANGAS	Dictionary class 41 gas
PROPN_KANGASALA	inflects like NOUN_OMENA except for adessive which is ‘kangasalla’
PROPN_KANKAHAT	Plural-only proper noun with i:e stem and kk:k gradation
PROPN_KANNEL	Dictionary class 49 nel
PROPN_KARRAT	Plural-only proper noun with i:e stem and kk:k gradation
PROPN_KASTANJETIT	Dictionary class xxx tit plurale tantum
PROPN_KASTIKE	Dictionary class 48 back ke
PROPN_KASTILJAT	Plural-only proper noun with i:e stem and kk:k gradation
PROPN_KAUSI	Dictionary class 27 back
PROPN_KEHVELI	Dictionary class 6 front
PROPN_KENGÄT	Dictionary class xxx a front kg plurale tantum
PROPN_KENKÄ	Dictionary class 10 frot k~g
PROPN_KENTTÄ	Dictionary class 10 front t~0
PROPN_KENTÄT	Plural-only proper noun with i:e stem and kk:k gradation
PROPN_KERITSIMET	Dictionary class 31 t fr plurale tantum
PROPN_KERTA	Dictionary class 9 t~r
PROPN_KEVÄT	Dictionary class 44 Nominalised nut participles have special inflection just as well.
PROPN_KIDE	Dictionary class 48 front de
PROPN_KIELTO	Dictionary class 1lto
PROPN_KIERRE	Dictionary class 48 fron re
PROPN_KIHARAT	Dictionary class xxxihi t plurale tantum
PROPN_KIINNE	Dictionary class 48 front ne
PROPN_KILPI	Dictionary class 7 front p~v
PROPN_KINNAS	Dictionary class 41 nas
PROPN_KIRITTÄRET	Plural-only proper noun with i:e stem and kk:k gradation
PROPN_KIRJA	Dictionary class 9 Notably, the basic a:o paradigm does not support many ä:ö cases.
PROPN_KIRVES	Dictionary class 41 es front
PROPN_KITARA	Proper noun with a:o stem
PROPN_KIVI	Dictionary class 7 front
PROPN_KLUMPIT	Plural-only proper noun with i:e stem and kk:k gradation
PROPN_KOE	Dictionary class 48 back 0k
PROPN_KOKO	k:’ should be obligatory but new rules allow k:0 for ‘koko’
PROPN_KOMPA	Dictionary class 10 back p~m
PROPN_KORPI	Dictionary class 7 back p~v
PROPN_KORTES	Proper nouns with tes:ttee stems
PROPN_KORTET	Proper nouns with tet: stems
PROPN_KORTTI	Proper noun with i:e stems and tt:t gradations
PROPN_KORVET	Plural-only proper noun with i:e stem and kk:k gradation
PROPN_KOUVOT	Plural-only proper noun with i:e stem and kk:k gradation
PROPN_KREUS	proper noun s:0 or NOUN_PUNK possible
PROPN_KUITU	Dictionary class 1to
PROPN_KUMMUT	Plural-only proper noun with i:e stem and kk:k gradation
PROPN_KUNGFU	Dictionary class 21 u back
PROPN_KUNNAT	Plural-only proper noun with i:e stem and kk:k gradation
PROPN_KUNTA	Dictionary class 10 back t~n
PROPN_KUOPAT	Dictionary class xxx a back p plurale tantum
PROPN_KUOPPA	Dictionary class 10 back p~0
PROPN_KUPPI	Dictionary class 5 back p~0
PROPN_KUTSUNTA	Dictionary class 9 t~n
PROPN_KUULOKKEET	Dictionary class kkkeeet plurale tantum
PROPN_KUUS	follows NUM_KUUSI pattern, except singular nominative
PROPN_KYDÖT	Plural-only proper noun with i:e stem and kk:k gradation
PROPN_KYKY	Dictionary class 1cyky
PROPN_KYLKIÄINEN	Dictionary class 38 front
PROPN_KYLÄNVANHIN	Proper nouns with superlative-like stems
PROPN_KYNNET	Plural-only proper noun with i:e stem and kk:k gradation
PROPN_KYNNÄÄT	Plural-only proper noun with i:e stem and kk:k gradation
PROPN_KÄKI	Dictionary class 7 front k~0
PROPN_KÄMMEKKÄ	Dictionary class 14 front
PROPN_KÄPY	Dictionary class 1py
PROPN_KÄPÄLÄ	Dictionary class 11 front Some a stems with a:o variation have slightly different set of allomorphs
PROPN_KÄRJET	Plural-only proper noun with i:e stem and kk:k gradation
PROPN_KÄRRY	Dictionary class 1y
PROPN_KÄRSÄKÄS	Dictionary class 41 käs
PROPN_KÄRÄJÄT	Plural-only proper noun with i:e stem and kk:k gradation
PROPN_KÄSITE	Dictionary class 48 front te
PROPN_KÄÄNTÖ	Dictionary class 1ntö
PROPN_KÖNGÄS	Dictionary class 41 gäs
PROPN_KÖYHYYS	Dictionary class 40 front Some s final words have special lengthening inflection.
PROPN_KÖYSI	Dictionary class 27 front
PROPN_KÖÖ	Dictionary class 18 ö
PROPN_LAET	Plural-only proper noun with i:e stem and kk:k gradation
PROPN_LAHDET	Plural-only proper noun with i:e stem and kk:k gradation
PROPN_LAHTI	Dictionary class 7 back t~d
PROPN_LAIDUN	Dictionary class 33 back dun
PROPN_LAKI	Dictionary class 5 back k~’~0
PROPN_LAMMET	Plural-only proper noun with i:e stem and kk:k gradation
PROPN_LAMMI	Plural-only proper noun with i:e stem and kk:k gradation
PROPN_LAMMIT	Plural-only proper noun with i:e stem and kk:k gradation
PROPN_LANKA	Dictionary class 9 k~g
PROPN_LANNET	Plural-only proper noun with i:e stem and kk:k gradation
PROPN_LASIT	Dictionary class xxx sit plurale tantum
PROPN_LEHDET	Dictionary class 7 front t~d plurale tantum
PROPN_LEHTI	Dictionary class 7 front t~d
PROPN_LEIKKUU	Dictionary class 17 u Monosyllabic long vowel stems have illative suffixes of form -hVn.
PROPN_LEIPÄ	Dictionary class 10 front p~v
PROPN_LENTTEE	Proper nouns with tee-stems
PROPN_LEPAKKO	Dictionary class 4 kko
PROPN_LIEMI	Dictionary class 25 front The -si words that originate from old -te stems have the consonant gradation patterns left in their stems. The si is only in nominative stem and this class mainly concerns stems that are old enough to have undergone ti>si transformation.
PROPN_LIITTOUTUNEET	Dictionary class nut plurale tantum
PROPN_LIIVIT	Dictionary class xxx iiiit plurale tantum
PROPN_LINGOT	Plural-only proper noun with i:e stem and kk:k gradation
PROPN_LINTU	Dictionary class 1ntu
PROPN_LIPEÄ	Dictionary class 15 eä
PROPN_LIPOTTARET	Plural-only proper noun with i:e stem and kk:k gradation
PROPN_LIPPU	Dictionary class 1pu
PROPN_LIUKU	Dictionary class 1ku with obligatory apostrophe k:’
PROPN_LIVVADIEVÁT	Livvadievát
PROPN_LOKA	Dictionary class 9 k~0 with optional ’
PROPN_LOKKI	Dictionary class 5 back k~0
PROPN_LOMMOL	Proper nouns with mmol-stems
PROPN_LOTTE	Dictionary class 8 t~0 back
PROPN_LOUET	Plural-only proper noun with i:e stem and kk:k gradation
PROPN_LUHDAT	Plural-only proper noun with i:e stem and kk:k gradation
PROPN_LUKU	Dictionary class 1cuku
PROPN_LUMME	Dictionary class 48 back me
PROPN_LUODE	Proper nouns with de:tee stens
PROPN_LUODES	Proper nouns with des:tee stems
PROPN_LUOKKA	Dictionary class 10 back k̃~0
PROPN_LUOLIKOT	Plural-only proper noun with i:e stem and kk:k gradation
PROPN_LUPA	Dictionary class 10 back p~v
PROPN_LUSIKKA	Dictionary class 14 back
PROPN_LÄHDES	Proper nouns with des:tee stems
PROPN_LÄHDET	Plural-only proper noun with i:e stem and kk:k gradation
PROPN_LÄHIN	Dictionary class 35 front
PROPN_LÄNSI	Dictionary class 27 front t~n
PROPN_LÄÄKE	Dictionary class 48 front ke
PROPN_LÖPÖ	Dictionary class 1pö
PROPN_MAA	Dictionary class 18 a
PROPN_MAJ	Dictionary class 22 j-final back
PROPN_MAKKARA	Dictionary class 12 back
PROPN_MAKU	Dictionary class 1ku
PROPN_MALKO	Proper nouns with o stems and k:0 gradation
PROPN_MALMÖ	inflects like NOUN_MÖMMÖ, hön illative possible
PROPN_MANNER	Dictionary class 49 ner
PROPN_MARKKINAT	Dictionary class xxx a front plurale tantum
PROPN_MATEE	Proper nouns with ee-stems
PROPN_MATKUET	Plural-only proper noun with i:e stem and kk:k gradation
PROPN_MC	proper noun bound particle, mostly foreign surname prefixes, compounds with propers without hyphen
PROPN_MERI	Non-Dictionary class meri
PROPN_MERTU	Proper nouns with rtu-stems
PROPN_METTE	Proper nouns with tte:te stems
PROPN_MIEHET	Plural-only proper noun with i:e stem and kk:k gradation
PROPN_MIELENGE	Proper nouns nge  stems
PROPN_MIELLE	Dictionary class 48 front le
PROPN_MIES	Dictionary class 42
PROPN_MITTA	Dictionary class 9 t~0
PROPN_MONSIEUR	Dictionary class 22 ö
PROPN_MULTA	Dictionary class 10 back t~l
PROPN_MURTEET	Plural-only proper noun with i:e stem and kk:k gradation
PROPN_MYRKKY	Dictionary class 1ky
PROPN_MÄET	Plural-only proper noun with i:e stem and kk:k gradation
PROPN_MÄNNYT	Plural-only proper noun with i:e stem and kk:k gradation
PROPN_MÄNTY	Dictionary class 1nty
PROPN_MÄTTÄÄT	Plural-only proper noun with i:e stem and kk:k gradation
PROPN_MÖMMÖ	Dictionary class 1ö
PROPN_MÖRKÖ	Dictionary class 1rkö
PROPN_NALLE	Dictionary class 8 back
PROPN_NEITSYT	Dictionary class 43 front
PROPN_NEUVOTTELUT	Dictionary class 3lut plurale tantum
PROPN_NG	Vowelless foreign proper nouns, tentatively inflects like zen, punk
PROPN_NIEMET	Plural-only proper noun with i:e stem and kk:k gradation
PROPN_NIHTI	Dictionary class 5 front t~d
PROPN_NIITUT	Plural-only proper noun with i:e stem and kk:k gradation
PROPN_NIITYT	Plural-only proper noun with i:e stem and kk:k gradation
PROPN_NIMETÖIN	Proper nouns with old caritive töin stems
PROPN_NIMETÖN	Dictionary class 34 tän
PROPN_NISSE	Dictionary class 8 front
PROPN_NOKI	Dictionary class 7 back k~0
PROPN_NOUGAT	Dictionary class 22 a
PROPN_NUGAA	Dictionary class 20 a
PROPN_NUKKE	Dictionary class 8 k~0 back
PROPN_NÄKY	Dictionary class 1ky
PROPN_NÄLKÄ	Dictionary class 10 front k~0
PROPN_OLUT	Dictionary class 43 back
PROPN_ONKI	Dictionary class 7 back k~g
PROPN_ONNET	Plural-only proper noun with i:e stem and kk:k gradation
PROPN_ONNI	Dictionary class 7 back
PROPN_OOKOO	Dictionary class 18 o
PROPN_OPINNOT	Dictionary class 1not plurale tantum
PROPN_OSATON	Dictionary class 34 ton
PROPN_OSOITE	Proper nouns with te:ttee stems
PROPN_PAIKAT	Dictionary class xxx kAt plurale tantum
PROPN_PANKIT	Plural-only proper noun with i:e stem and kk:k gradation
PROPN_PARFAIT	Dictionary class 22 e
PROPN_PATA	Dictionary class 9 t~d
PROPN_PATEE	Dictionary class 20 e
PROPN_PATSAS	Dictionary class 41 as
PROPN_PEIPOT	Plural-only proper noun with i:e stem and kk:k gradation
PROPN_PELKO	k:0 without optional ’
PROPN_PELTI	Dictionary class 5 front t~l
PROPN_PENGER	Dictionary class 49 ger
PROPN_PIDOT	Dictionary class 1ot plurale tantum
PROPN_PII	Dictionary class 18 i
PROPN_PIIROA	dictionary class 15 oa, lexicalised ADJ_AINOA nouns
PROPN_PIPPALOT	Dictionary class 3iot plurale tantum
PROPN_PISTE	Dictionary class 48 Front
PROPN_POHATTA	Dictionary class 14 back t0
PROPN_POHJE	Dictionary class 48 back je
PROPN_POIKA	Non-dictionary class poika
PROPN_POJAT	Dictionary class pojat plurale tantum
PROPN_POLITIIKKA	Dictionary class 9 k~0
PROPN_PONSI	Dictionary class 27 back t~n
PROPN_PORRAS	Dictionary class 41 ras The word mies has special s:h variation pattern.
PROPN_PORTAAT	Dictionary class rtaat plurale tantum
PROPN_PROBLEEMA	Dictionary class 11 back
PROPN_PUHELIN	Dictionary class 33 back
PROPN_PUNK	New loan words ending in consonant may be inflected as i stem words Dictionary class 5 back no i
PROPN_PUU	Dictionary class 18 u
PROPN_PUUT	Dictionary class xx puu t plurale tantum
PROPN_PYHTÄÄ	Proper nouns with ää-stems
PROPN_PYTTY	Dictionary class 1ty
PROPN_PYY	Dictionary class 18 y
PROPN_PÄÄ	Dictionary class 18 ä
PROPN_PÖKSYT	Dictionary class 1y plurale tantum
PROPN_PÖLHÄÄT	Plural-only proper noun with i:e stem and kk:k gradation
PROPN_PÖLLÖT	Plural-only proper noun with i:e stem and kk:k gradation
PROPN_PÖNTTÖ	Dictionary class 1tö
PROPN_PÖYTÄ	Dictionary class 10 front t~d
PROPN_RAGUU	Dictionary class 20 u
PROPN_RAKENNE	Dictionary class 48 back ne
PROPN_RAMPA	Dictionary class 9 p~m
PROPN_RANGAT	Plural-only proper noun with i:e stem and kk:k gradation
PROPN_RANNAT	Plural-only proper noun with i:e stem and kk:k gradation
PROPN_RAPPE	Proper nouns with ppe:pe-stems
PROPN_RAPPUSET	Dictionary class 38 nen plurale tantum
PROPN_RAPUT	Dictionary class 1put plurale tantum
PROPN_RATAS	Dictionary class 41 tas
PROPN_RAUDAT	Dictionary class xxx dat plurale tantum
PROPN_RAUNIOT	Dictionary class 2iot plurale tantum
PROPN_RAVUT	Plural-only proper noun with i:e stem and kk:k gradation
PROPN_REGGAE	class 21 with
PROPN_REIKÄ	Dictionary class 10 back k~’~0
PROPN_REIÄT	Plural-only proper noun with i:e stem and kk:k gradation
PROPN_RENKAAT	Dictionary class gaat plurale tantum
PROPN_RIIPI	Proper nouns with i:e and p:v 
PROPN_RIIVET	Plural-only proper nouns with i:e and p:v
PROPN_RIMMI	Proper nouns with mmi:mmit variations
PROPN_RIMMIT	Plural-only proper noun with i:e stem and kk:k gradation
PROPN_RIMPI	Dictionary class 7 front p~m
PROPN_RINNET	Plural-only proper noun with i:e stem and kk:k gradation
PROPN_RINTEET	Plural-only proper noun with i:e stem and kk:k gradation
PROPN_RIPE	Dictionary class 48 front pe
PROPN_RIPSET	Dictionary class xxx ripset plurale tantum
PROPN_RIUTAT	Plural-only proper noun with i:e stem and kk:k gradation
PROPN_ROITOT	Plural-only proper noun with i:e stem and kk:k gradation
PROPN_ROMPAAT	Plural-only proper noun with i:e stem and kk:k gradation
PROPN_ROSÉ	Dictionary class 21 e back
PROPN_ROTTA	Dictionary class 10 back t~0
PROPN_RUIPELO	Dictionary class 2o
PROPN_RUIS	Dictionary class 41 is
PROPN_RUMPU	Dictionary class 1mpu
PROPN_RUNKO	Dictionary class 1nko
PROPN_RUOKO	Between three vowels where k is surrounded by same vowels the k becomes obligatorily ’. When the vowels are different, it becomes optionally ’ (as in N_TEKO), and after consonant other than s it is k ~ 0 (as in N_UKKO). Dictionary class 1ko
PROPN_RUOPPAAT	Plural-only proper noun with i:e stem and kk:k gradation
PROPN_RUUHI	Dictionary class 24 back
PROPN_RUUMIS	Dictionary class 41 is back
PROPN_RUUVI	Dictionary class 5 back
PROPN_RYPÄS	Dictionary class 41 päs
PROPN_RYYPPY	Dictionary class 1py
PROPN_RÄJÄYTYS	Dictionary class 39 front Some of the s final stems have additional s:t:d variation in singular stems. Most notably, the UUs derivations are in this class.
PROPN_RÄMEET	Plural-only proper noun with i:e stem and kk:k gradation
PROPN_RÄMEÄT	Plural-only proper noun with i:e stem and kk:k gradation
PROPN_RÄMIÄT	Plural-only proper noun with i:e stem and kk:k gradation
PROPN_SAAPAS	Dictionary class 41 pas
PROPN_SAARET	Plural-only proper noun with i:e stem and kk:k gradation
PROPN_SAKSET	Dictionary class xxx sakset plurale tantum
PROPN_SALONTEET	Plural-only proper noun with i:e stem and kk:k gradation
PROPN_SALPA	Dictionary class 9 p~v
PROPN_SAMMALET	Plural-only proper noun with i:e stem and kk:k gradation
PROPN_SAMPI	Dictionary class 7 back p~m
PROPN_SAMPO	Dictionary class 1mpo
PROPN_SEIKKAILU	Dictionary class 2u
PROPN_SEIVÄS	Dictionary class 41 väs
PROPN_SELENE	Proper nouns with new e stems and front harmony
PROPN_SELJÄT	Plural-only proper noun with i:e stem and kk:k gradation
PROPN_SEPPÄ	Dictionary class 10 front p~0
PROPN_SERGEJ	Dictionary class 22 j-final front
PROPN_SERKUKSET	Dictionary class kset plurale tantum
PROPN_SHOW	Dictionary class 22 u
PROPN_SIEMEN	Dictionary class 32 front
PROPN_SIIRTO	Dictionary class 1rto
PROPN_SIIVILÄ	Dictionary class 12++ front
PROPN_SILAKAT	Dictionary class 14 kat plurale tantum
PROPN_SILMÄKKEET	Plural-only proper noun with i:e stem and kk:k gradation
PROPN_SISÄLTÖ	Dictionary class 1ltö
PROPN_SIUNAAMATTOMAT	Plural-only proper noun with i:e stem and kk:k gradation
PROPN_SIVISTYNYT	Dictionary class 47 front
PROPN_SKEITTI	Dictionary class 5 front t~0
PROPN_SOINTI	Dictionary class 5 back t~n
PROPN_SOKEA	The a-final words ending in long vowels with syllable boundary have a:0 variation and more allomorphs for plyral genitive or illative. Dictionary class 15 ea
PROPN_SOTA	Dictionary class 10 back t~d
PROPN_SPOTIFY	New proper nouns with back and front harmonies, no stem variations
PROPN_STADION	Dictionary class 6 back no i
PROPN_SUHTEET	Dictionary class taad plurale tantum
PROPN_SUKAT	Dictionary class xxx a front k0 plurale tantum
PROPN_SULKA	Dictionary class 9 k~0 without optional ’
PROPN_SUODATIN	Dictionary class 33 back tin
PROPN_SUOT	Plural-only proper noun with i:e stem and kk:k gradation
PROPN_SYDÄN	Like NOUN_ELIN, allows common non-standards of type: sydämmen, sytämen
PROPN_SYLI	Proper nouns with i:e variations and
PROPN_SYÖMINGIT	Dictionary class xxx git fornt plurale tantum
PROPN_SÄNKY	Dictionary class 1nky
PROPN_SÄRKÄT	Plural-only proper noun with i:e stem and kk:k gradation
PROPN_SÄÄDIN	Dictionary class 33 fron din
PROPN_SÄÄRET	Plural-only proper noun with i:e stem and kk:k gradation
PROPN_TAIMI	Dictionary class 25 back
PROPN_TAIVAL	Dictionary class 49 val
PROPN_TALKOOT	Dictionary class xxx kooot plurale tantum
PROPN_TALO	The most basic noun stem does not have any stem internal variation and uses few commonest allomorphs. The words in this class are either bisyllabic or have one of common derivational suffixes: sto, .... The nouns in this class end in o, u, y or ö, which determines their illative suffix and therefore exact classification:
PROPN_TARVE	Dictionary class 48 back ve
PROPN_TAUDIT	Dictionary class xxx dit plurale tantum
PROPN_TAUTI	Dictionary class 5 back t~d
PROPN_TAVAT	Dictionary class xxx vat plurale tantum
PROPN_TEE	Dictionary class 18 e
PROPN_TEHDAS	Dictionary class 41 das
PROPN_TEHTAAT	Plural-only proper noun with i:e stem and kk:k gradation
PROPN_TEKO	Between two vowels, the weak grade of k is optionally an apostrophe instead. For k that is not optionally ’, for example when it is after a consonant other than s, the variation is k ~ 0 instead (e.g. N_UKKO). Dictionary class 1ko
PROPN_TIE	Dictionary class 19 ie
PROPN_TIENOO	Dictionary class 17 o
PROPN_TIETEET	Dictionary class xxx teet plurale tantum
PROPN_TIHVII	Proper nouns with ii-stems
PROPN_TIKKAAT	Dictionary class kaat plurale tantum
PROPN_TIKKU	Dictionary class 1ku
PROPN_TIPPA	Dictionary class 9 p~0
PROPN_TOIMET	Dictionary class 25 t plurale tantum
PROPN_TOKEE	Dictionary class 20 e
PROPN_TONGIT	Dictionary class xxx git plurale tantum
PROPN_TORTTU	Dictionary class 1tu
PROPN_TOULAT	Plural-only proper noun with i:e stem and kk:k gradation
PROPN_TRIKOO	Dictionary class 20 o
PROPN_TULI	Dictionary class 23
PROPN_TUNTO	Dictionary class 1nto
PROPN_TUOMIO	The words with stem vowel o, u, y, ö preceded by vowels still have no more stem variation than other cases, but give yet another pattern of allomorphs for plural partitives and genitives Dictionary class 3o There's plenty of imaginable non-standard allomorph forms after long vowels
PROPN_TYTÄR	Dictionary class 32 tär
PROPN_TYTÖT	Dictionary class 1töt plurale tantum
PROPN_TYYLI	Dictionary class 5 front
PROPN_TYYPPI	Dictionary class 5 front p~0
PROPN_TYÖ	Dictionary class 19 yö
PROPN_TYÖTTÖMÄT	Plural-only proper noun with i:e stem and kk:k gradation
PROPN_TÖLPÄKÖT	Plural-only proper noun with i:e stem and kk:k gradation
PROPN_TÖLPÄT	Plural-only proper noun with i:e stem and kk:k gradation
PROPN_TÖRPPÖ	Dictionary class 1pö
PROPN_UKKO	Proper nouns with o stem and  kk:k gradations
PROPN_ULAPPA	Dictionary class 14 back p̃0
PROPN_VAADIN	Dictionary class 33 back din
PROPN_VAAKA	Dictionary class 9 k~’ with obligatory ’
PROPN_VAANII	Proper nouns with ii-stems
PROPN_VAASAN	non-inflecting proper nouns
PROPN_VAINAA	Dictionary class 17 a
PROPN_VAKUUTUS	Dictionary class 39 back
PROPN_VALJAAT	Dictionary class jaat plurale tantum
PROPN_VALLAT	Dictionary class xxx lat plurale tantum
PROPN_VALTA	Dictionary class 9 t~l
PROPN_VANHEMMAT	Dictionary class xxx matt plurale tantum
PROPN_VANKI	Dictionary class 5 back k~g
PROPN_VARAS	Dictionary class 41 as
PROPN_VARAT	Dictionary class xxx rrt plurale tantum
PROPN_VARPAAT	Plural-only proper noun with i:e stem and kk:k gradation
PROPN_VARSI	Dictionary class 27 back t~r
PROPN_VARVAS	Dictionary class 41 vas
PROPN_VEHKEILY	Dictionary class 2y
PROPN_VEITSI	Dictionary class 27 tsi front The -ksi stem in haaksi includes k:h variation.
PROPN_VELJET	Plural-only proper noun with i:e stem and kk:k gradation
PROPN_VERSAILLES	Dictionary class 22 i back
PROPN_VETO	Dictionary class 1to
PROPN_VETY	Dictionary class 1ty
PROPN_VIENTI	Dictionary class 5 front t~n
PROPN_VIHKIÄISET	Dictionary class 38 nen fornt plurale tantum
PROPN_VIIRRET	Plural-only proper noun with i:e stem and kk:k gradation
PROPN_VIIS	Proper nouns with iis:iide stems (from numeral 5)
PROPN_VIIVE	Dictionary class 48 front ve
PROPN_VIKA	Dictionary class 9 k~’~0
PROPN_VINKU	Dictionary class 1nku
PROPN_VIRSI	Dictionary class 27 front t~r
PROPN_VODĂ	for foreign words ending in ǎ that inflects like a
PROPN_VOIMA	Dictionary class 11 back
PROPN_VON	proper noun particle, no inflection, no compounding, for some foreign surname etc. patronymical constructs
PROPN_VUO	Dictionary class 19 uo
PROPN_VUODET	Dictionary class 27 det plurale tantum
PROPN_VUOLLE	Dictionary class 48 back le
PROPN_VUOLLET	Plural-only proper noun with i:e stem and kk:k gradation
PROPN_VÄRTÖ	Proper nouns with ö stems and rt:rr gradations
PROPN_WADA	An acronym that is also inflected like a-final noun without a colon, e.g. WADA ~ WADAn. Plurals only with colon.
PROPN_YHTIÖT	Plural-only proper noun with i:e stem and kk:k gradation
PROPN_YKSIKKÖ	Dictionary class 4 kkö
PROPN_YLÄNKÖ	Dictionary class 1nkö
PROPN_YLÖÖ	Proper nouns with öö stems
PROPN_YMPÄRYSTÄ	Proper nouns with ä:0 stems
PROPN_YRITTÄ	Proper nouns with ttä stems
PROPN_YSTÄVYKSET	Dictionary class kset fr plurale tantum
PROPN_YÖKKÖ	Dictionary class 1kö
PROPN_ZEN	Dictionary class 5 front no i
PROPN_ZOMBIE	Similar inflection exists in limited amounts in new loan words that are written as pronounced (thus taking no stem variation but still ending with long vowels with a syllable boundary) Dictionary class 3eta
PROPN_ÄYRÄS	Dictionary class 41 äs
PUNCT_NONSTD_DASH_LOOP	accounts for repeated hyphen-like characters
PUNCT_NONSTD_EXCL_LOOP	accounts for repeated exclamation-like characters
PUNCT_PILKKU	punctuation, rare back inflection plausible
PUNCT_PISTE	punctuation, rare front inflection plausible
SCONJ_ETTÄ	sub-ordinating conjunction, no inflections
SYM_,	symbol, back inflection with : and compounding with -
SYM_.	symbols, front inflection with : and compounding with -
SYM_§	symbols, inflection with : and compounding with -
SYM_¢	symbols, inflection with : and compounding with -
SYM_$	symbols, inflection with : and compounding with -
SYM_£	symbols, inflection with : and compounding with -
SYM_€	symbols, inflection with : and compounding with -
SYM_CELSIUS	symbols, inflection with : and compounding with -
SYM_GRAMMA	symbols, inflection with : and compounding with -
SYM_JOULE	symbols, inflection with : and compounding with -
SYM_METRI	symbols, inflection with : and compounding with -
SYM_TUOTE	symbols, inflection with : and compounding with -
SYM_WEBER	symbols, inflection with : and compounding with -
SYM_Ω	symbols, inflection with : and compounding with -
VERB_AALLOTA	Dictionary class75 lota
VERB_AHNEHTIA	Dictionary class61 back t~d
VERB_AMPUA	Dictionary class52 p~m u
VERB_ARVAILLA	Dictionary class67 back i~e l
VERB_ARVATA	Dictionary class73 back
VERB_AUTTAA	Dictionary class56 back t~0
VERB_DIGATA	Dictionary class73 back 0~g
VERB_EHTIÄ	Dictionary class61 front t~d
VERB_EI	Negation verb ‘ei’ has heteroclitic inflection
VERB_ENTÄÄ	Dictionary class55 front t~n
VERB_ERATA	Dictionary class72 back 0~k
VERB_ETUILLA	Dictionary class67 back i~e l
VERB_HALAJAA	Dictionary class77 back
VERB_HALJETA	Dictionary class74 back j~ke
VERB_HALUTA	Dictionary class74 back with uu dial
VERB_HAPATA	Dictionary class72 back 0~p
VERB_HARPPOA	Dictionary class52 p~0 o
VERB_HAUKKOA	Dictionary class52 k~0 o
VERB_HELLITÄ	Dictionary class75 litä
VERB_HELPOTA	Dictionary class72 back 0~p o
VERB_HELÄJÄÄ	Dictionary class77 front
VERB_HERMOTTUA	Dictionary class52 t~0 u
VERB_HERÄTELLÄ	Dictionary class67 front l 0t
VERB_HIIPUA	Dictionary class52 p~v u
VERB_HIVENTÄÄ	Dictionary class54 front t~n
VERB_HUMALTUA	Dictionary class52 t~l u
VERB_HUONONTAA	Dictionary class54 back t~n
VERB_HUUTAA	Dictionary class54 back
VERB_HYLJÄTÄ	Dictionary class73 front j~k
VERB_HYLKIÄ	Dictionary class61 back k~j
VERB_HYPELLÄ	Dictionary class67 front l 0p
VERB_HYPPIÄ	Dictionary class61 front p~0
VERB_HÄVÄISTÄ	Dictionary class66 front v p
VERB_ILJETÄ	Dictionary class74 front j~k
VERB_INNOTA	Dictionary class74 back t~no
VERB_IRROTA	Dictionary class74 back t~to
VERB_ISÄNNÖIDÄ	Dictionary class68 front
VERB_JAHDATA	Dictionary class73 back d~r
VERB_JOUTAA	Dictionary class55 back
VERB_JUOSTA	Dictionary class70 back
VERB_JYRKETÄ	Dictionary class72 front 0~k
VERB_JÄÄDÄ	Dictionary class63 ä
VERB_KAATAA	Dictionary class57 back
VERB_KAIKOTA	Dictionary class74 back 0~k
VERB_KAIPAELLA	Dictionary class67 back e~i l
VERB_KAIVATA	Dictionary class73 back v~p
VERB_KALPPIA	Dictionary class61 back p~0
VERB_KAMMETA	Dictionary class74 back p~mu
VERB_KANTAA	Dictionary class56 back t~n
VERB_KARHETA	Dictionary class72 back
VERB_KARHUTA	Dictionary class74 back
VERB_KASVAA	Dictionary class56 back
VERB_KATSOA	The regular o stem with dialectally gradating ts variations
VERB_KAUNISTUA	The u stems have no stem variation: Dictionary class52u
VERB_KAVETA	Dictionary class72 back v~p
VERB_KERETÄ	Dictionary class74 front 0~k e
VERB_KERITÄ	Dictionary class75 itä
VERB_KIERTYÄ	Dictionary class52 t~r y
VERB_KIETOA	Dictionary class52 t~d o
VERB_KIHERRELLÄ	Dictionary class67 front l r~t
VERB_KIILLELLÄ	Dictionary class67 frpnt l l~t
VERB_KIINNETÄ	Dictionary class72 front n~t
VERB_KIITÄÄ	Dictionary class55 front
VERB_KIRVOTA	Dictionary class74 back v~po
VERB_KIVETTYÄ	Dictionary class52 t~0 y
VERB_KIVETÄ	Dictionary class74 front
VERB_KIVISTÄÄ	Dictionary class53 front
VERB_KIVUTA	Dictionary class74 back v~p
VERB_KOMENNELLA	Dictionary class67 back l n~t
VERB_KONTIA	Dictionary class61 back t~n
VERB_KOPIOIDA	Dictionary class62 back
VERB_KORVETA	Dictionary class74 back v~pe
VERB_KOSIA	Dictionary class61 back
VERB_KOUKUTA	Dictionary class74 front 0~k u
VERB_KUHERTAA	Dictionary class54 back t~r
VERB_KUKKIA	Dictionary class61 back k~0
VERB_KUMMUTA	Dictionary class74 back m~p
VERB_KUTEA	Dictionary class58 back t~d
VERB_KYNTÄÄ	Dictionary class53 front t~n
VERB_KYTKEÄ	Dictionary class58 front
VERB_KÄRKKYÄ	Dictionary class52 k~0 y
VERB_KÄYDÄ	Dictionary class65
VERB_KÄÄNNELLÄ	Dictionary class67 front l n~t
VERB_LASSOTA	Dictionary class75 back
VERB_LEIKELLÄ	Dictionary class67 front l 0k
VERB_LEPPYÄ	Dictionary class52 p~0 y
VERB_LEPÄILLÄ	Dictionary class67 front i~e l
VERB_LEUDOTA	Dictionary class72 back d~t
VERB_LEVÄTÄ	Dictionary class73 front v~p
VERB_LIIDUTA	Dictionary class74 back d~tu
VERB_LOBATA	Dictionary class73 back 0~b
VERB_LOITOTA	Dictionary class72 back 0~t
VERB_LOPPUA	Dictionary class52 p~0 u
VERB_LOTOTA	Dictionary class74 back 0~to
VERB_LUNTATA	Dictionary class73 back 0~t
VERB_LUUTUTA	Dictionary class74 back 0~tu
VERB_LÄHTEÄ	Dictionary class60
VERB_LÄMMETÄ	Dictionary class72 front m~p
VERB_LÄMMITÄ	Dictionary class75 mitä
VERB_LÄNTÄTÄ	Dictionary class73 front 0~t
VERB_MARISTA	Dictionary class66 back
VERB_MAUKUA	Dictionary class52 k~0’ u
VERB_MELLAKOIDA	Dictionary class68 back
VERB_MENNÄ	Dictionary class67 front n
VERB_MERKITÄ	Dictionary class69 front
VERB_MIELTYÄ	Dictionary class52 t~l y
VERB_MIETTIÄ	Dictionary class61 front t~0
VERB_MOITTIA	Dictionary class61 back t~0
VERB_MOJAHTAA	Dictionary class53 back t~d
VERB_MORKATA	Dictionary class73 back 0~k
VERB_MULLATA	Dictionary class73 back l~t
VERB_MUODOTA	Dictionary class75 dota
VERB_MUTRISTAA	Dictionary class53 back
VERB_MYYDÄ	Dictionary class63 y
VERB_MÄDÄTÄ	Dictionary class72 front d~t
VERB_MÄIKYÄ	Dictionary class52 k~0’ y
VERB_MÖNKIÄ	Dictionary class61 front k~g
VERB_NAKELLA	Dictionary class67 back l 0k
VERB_NAKERRELLA	Dictionary class67 back l r~t
VERB_NIUKETA	Dictionary class72 back 0~k
VERB_NUOKKUA	Dictionary class52 k~0 u
VERB_NÄHDÄ	Dictionary class71
VERB_NÄPERTÄÄ	Dictionary class54 front t~r
VERB_OLLA	The verb olla has very peculiar and heteroclitic inflection with lot of common short forms in standard spoken Finnish
VERB_OMMELLA	Dictionary class67 back l m~p
VERB_ONKIA	Dictionary class61 back k~g
VERB_PALKITA	Dictionary class69 back
VERB_PANNA	Dictionary class67 back n
VERB_PEITOTA	Dictionary class75 tota
VERB_PENKOA	Dictionary class52 k~g o
VERB_PIDETÄ	Dictionary class72 front d~t e
VERB_PIERRÄ	Dictionary class67 front r
VERB_PIESTÄ	Dictionary class70 front
VERB_PINGOTA	Dictionary class74 back g~ko
VERB_POIKETA	Dictionary class74 back 0~k e
VERB_POLKEA	Dictionary class58 back k~j
VERB_PUKEA	Dictionary class58 back k~0
VERB_PULPUTA	Dictionary class74 back 0~p
VERB_PUNOA	The o stems have no stem variation: Dictionary class52o
VERB_PURKAA	Dictionary class53 back k~0
VERB_PUSERTUA	Dictionary class52 t~r u
VERB_PYYTÄÄ	Dictionary class54 front
VERB_PÄTEÄ	Dictionary class58 front t~d
VERB_RAAPIA	Dictionary class61 back p~v
VERB_RAIKAA	Dictionary class78 back
VERB_RANGAISTA	Dictionary class66 back k~g
VERB_RENNOTA	Dictionary class74 back t~no
VERB_REVETÄ	Dictionary class74 front v~pe
VERB_RIIPIÄ	Dictionary class61 front p~v
VERB_ROHJETA	Dictionary class.. back j~k
VERB_ROHTUA	Dictionary class52 t~d u
VERB_RYNNÄTÄ	Dictionary class73 front n~t
VERB_RYPEÄ	Dictionary class58 front p~v
VERB_RYSKIÄ	Dictionary class61 front
VERB_RYÖPYTÄ	Dictionary class75 pytä
VERB_RÄPSYTTÄÄ	Dictionary class53 front t~0
VERB_SAADA	Dictionary class63 a
VERB_SAARTAA	Dictionary class57 back t~r
VERB_SAMMOTA	Dictionary class74 back p~mu
VERB_SATAA	Dictionary class56 back t~d
VERB_SELVITÄ	Dictionary class75 itä
VERB_SIEPATA	Dictionary class73 back 0~p
VERB_SI’ITÄ	Dictionary class75 itä oblig ’
VERB_SILIYTYÄ	Dictionary class52 t~d y
VERB_SILPOA	Dictionary class52 p~v o
VERB_SIVALTAA	Dictionary class54 back t~l
VERB_SORTAA	Dictionary class53 back t~r
VERB_SOTKEA	Dictionary class58 back
VERB_SULATELLA	Dictionary class67 back l 0t
VERB_SUPETA	Dictionary class72 front 0~p
VERB_SURRA	Dictionary class67 back r
VERB_SUUNNATA	Dictionary class73 back n~t
VERB_SYÖDÄ	Dictionary class64 yö In past and conditional forms of käydä, the glide before suffix is marked even in normative orthography.
VERB_SYÖPYÄ	Dictionary class52 p~v y
VERB_SÄILÖÄ	The ö stems have no stem variation: Dictionary class52ö
VERB_SÄPSÄHDELLÄ	Dictionary class67 front l d~t
VERB_SÄRKEÄ	Dictionary class58 front k~j
VERB_SÖRKKIÄ	Dictionary class61 front k~0
VERB_TAITAA	Dictionary class76 back
VERB_TAKOA	Dictionary class52 k~0’ o
VERB_TAPELLA	Dictionary class67 back l 0p
VERB_TAPPAA	Dictionary class56 back p~0
VERB_TEMMATA	Dictionary class73 back m~p
VERB_TEMPOA	Dictionary class52 p~m o
VERB_TIETÄÄ	Dictionary class76 front
VERB_TIPAHDELLA	Dictionary class67 back l d~t
VERB_TODETA	Dictionary class74 back t~de
VERB_TUIKKAA	Dictionary class77 back
VERB_TULLA	like XXX but with short tuun style non-standards
VERB_TUNGETA	Dictionary class74 back g~ke
VERB_TUNKEA	Dictionary class58 back k~g
VERB_TUNTEA	Dictionary class59
VERB_TUODA	Dictionary class64 uo
VERB_TYHJENTYÄ	Dictionary class52 t~n y
VERB_TYLPETÄ	Dictionary class72 front 0~p
VERB_TYMPIÄ	Dictionary class61 frontp~m
VERB_TÄHDÄTÄ	Dictionary class73 front d~t
VERB_TÄHYTÄ	Dictionary class74 front
VERB_ULOTA	Dictionary class72 back 0~k o
VERB_UPOTA	Dictionary class74 back 0~p o
VERB_VAAHDOTA	Dictionary class74 back d~t
VERB_VAELLELLA	Dictionary class67 back l l~t
VERB_VAKAANTUA	Dictionary class52 t~n u
VERB_VARTOA	Dictionary class52 t~r o
VERB_VAVISTA	Dictionary class66 back v~p
VERB_VERRATA	Dictionary class73 back r~t
VERB_VIEDÄ	Dictionary class64 ie
VERB_VIEROITTAA	Dictionary class53 back t~0
VERB_VIHELTÄÄ	Dictionary class54 front t~l
VERB_VIITTOA	Dictionary class52 t~0 o
VERB_VINKUA	Dictionary class52 k~g u
VERB_VIPAJAA	Dictionary class77 back
VERB_VIRKKAA	Dictionary class56 back k~0
VERB_VONGATA	Dictionary class73 back g~k
VERB_VYYHDETÄ	Dictionary class74 front t~de
VERB_VÄHETÄ	Dictionary class72 rfont
VERB_VÄLPÄTÄ	Dictionary class73 frot 0~p
VERB_VÄNGÄTÄ	Dictionary class73 front g~k
VERB_YLTÄÄ	Dictionary class55 front t~l
VERB_YNNÄTÄ	Dictionary class73 front
VERB_YSKÄHTÄÄ	Dictionary class53 front t~d
VERB_YÖKÄTÄ	Dictionary class73 front 0~k
VERB_ÄHKÄÄ	Dictionary class78 front
VERB_ÄKSYILLÄ	Dictionary class67 frot l
VERB_ÄLLISTYÄ	The y stems have no stem variation: Dictionary class52y
VERB_ÄNGETÄ	Dictionary class74 front g~ke
VERB_ÄRISTÄ	Dictionary class66 front
VERB_ÖYKKÄRÖIDÄ	Dictionary class62 front
X_51eikä	Verbal conjunction compound ‘eikä’ («‘ja+ei’ and not) inflects from the first part like ‘ei’
X_51ettei	Verbal conjunction compounds of type ‘ettei’ («‘että+ei’) inflects from the end like ‘ei’
X_51äläkä	Partial inflection of imperative negation verb ‘älä’ and conjunction ‘ja’ inflects from first part like ‘ei’
X_FORGN_DE	new particles of German origin, such as: der, zu; used often in proper nouns like particles
X_FORGN_EN	new particles of English origin, such as: the, and, of; used often in proper nouns like particles
X_FORGN_SV	new particles of Swedish origin; used often in proper nouns like particles
X_IGNORE	words that need to be in lexicon for legacy reasons (stability, etc.) but shall not appear in real applications
X_SUFFIX_GOESWITH	some suffixes that appear mistokenised, such as ‘XXX:llä’ tokenised as XXX : llä
