lemma	NOUN	abbr
/	PUNCT	abbreviation
&	SYM	abbreviation
+	SYM	abbreviation
358	PROPN	acronym
4F	PROPN	acronym
a	NOUN	acronym
A	NOUN	acronym
$A	NOUN	acronym
å	NOUN	acronym
Å	NOUN	acronym
ä	NOUN	acronym
Ä	NOUN	acronym
A0	NOUN	acronym
A1	NOUN	acronym
A2	NOUN	acronym
A3	NOUN	acronym
A4	NOUN	acronym
A5	NOUN	acronym
aA	NOUN	acronym
AA	NOUN	acronym
ÅA	PROPN	acronym
AAL	PROPN	acronym
AAP	PROPN	acronym
ab	NOUN	acronym
Ab	ADV	abbreviation
ABB	PROPN	acronym
ABC	PROPN	acronym
abp	NOUN	acronym
aBq	NOUN	acronym
ABS	NOUN	acronym
aC	NOUN	acronym
a°C	NOUN	acronym
AC	NOUN	acronym
acd	NOUN	acronym
AC/DC	PROPN	acronym
ad	NOUN	acronym
ADAC	PROPN	acronym
adhd	NOUN	acronym
ADP	NOUN	acronym
ADSL	NOUN	acronym
ADT	NOUN	acronym
AdultTV	PROPN	acronym
AED	NOUN	acronym
AEGEE	PROPN	acronym
AEK	PROPN	acronym
aF	NOUN	acronym
Af	NOUN	acronym
AFA	NOUN	acronym
AFN	NOUN	acronym
AFP	PROPN	acronym
AFS	PROPN	acronym
AFTA	PROPN	acronym
ag	NOUN	acronym
AG	NOUN	acronym
AGEA	NOUN	acronym
agrol.	NOUN	abbreviation
agron.	NOUN	abbreviation
aGy	NOUN	acronym
aH	NOUN	acronym
Ah	NOUN	acronym
AHKA	NOUN	acronym
aHz	NOUN	acronym
ÄI	NOUN	acronym
AIA	PROPN	acronym
AICA	PROPN	acronym
aids	NOUN	acronym
AIECE	PROPN	acronym
AIESEC	PROPN	acronym
AIG	PROPN	acronym
aik.	NOUN	abbreviation
Air100	PROPN	acronym
Airbnb	PROPN	acronym
AIV	NOUN	acronym
aJ	NOUN	acronym
aK	NOUN	acronym
akat	NOUN	acronym
akat.	NOUN	abbreviation
AKAVA	PROPN	acronym
AKE	PROPN	acronym
AKL	PROPN	acronym
AKS	PROPN	acronym
AKT	PROPN	acronym
ÄKT	PROPN	acronym
al.	NOUN	abbreviation
AL	PROPN	acronym
ALBA	PROPN	acronym
alik.	NOUN	abbreviation
alil.	NOUN	abbreviation
alk.	NOUN	abbreviation
ALK	NOUN	acronym
ALL	NOUN	acronym
alm	NOUN	acronym
ALS	NOUN	acronym
alv	NOUN	acronym
alv.	NOUN	abbreviation
alx	NOUN	acronym
am	NOUN	acronym
a.m.	NOUN	abbreviation
AM	PROPN	acronym
AMD	PROPN	acronym
amir.	NOUN	abbreviation
amk	NOUN	acronym
amol	NOUN	acronym
AMR	PROPN	acronym
aN	NOUN	acronym
ÅN	PROPN	acronym
Analyse2	PROPN	acronym
ANC	PROPN	acronym
ANG	NOUN	acronym
anon.	NOUN	abbreviation
ANP	PROPN	acronym
ANSI	PROPN	acronym
ANWR	PROPN	acronym
ao.	NOUN	abbreviation
AO	NOUN	acronym
äo	NOUN	acronym
ÄO	NOUN	acronym
AOA	NOUN	acronym
AOK	NOUN	acronym
AOL	PROPN	acronym
ÄOL	PROPN	acronym
AON	NOUN	acronym
AOR	NOUN	acronym
AOVA	PROPN	acronym
ap.	NOUN	abbreviation
AP	PROPN	acronym
aPa	NOUN	acronym
APEC	PROPN	acronym
API	NOUN	acronym
apul.	NOUN	abbreviation
apul.prof.	NOUN	abbreviation
ARA	PROPN	acronym
arad	NOUN	acronym
ARENE	PROPN	acronym
Arg$	NOUN	acronym
ark	NOUN	acronym
ark.	NOUN	abbreviation
ARK	PROPN	acronym
arkkit.	NOUN	abbreviation
ARL	NOUN	acronym
ARM	PROPN	acronym
ARP	NOUN	acronym
ARS	NOUN	acronym
art.	NOUN	abbreviation
arv.	NOUN	abbreviation
as	NOUN	acronym
as.	NOUN	abbreviation
aS	NOUN	acronym
AS	NOUN	acronym
A/S	NOUN	acronym
ASA	NOUN	acronym
ascii	NOUN	acronym
ASEAN	PROPN	acronym
ASEAN+3	PROPN	acronym
ASEM	PROPN	acronym
as.oy	NOUN	acronym
as.oy.	NOUN	abbreviation
AsOYL	NOUN	acronym
ASP	NOUN	acronym
asr	NOUN	acronym
ass.	NOUN	abbreviation
assist.	NOUN	abbreviation
aSv	NOUN	acronym
ASX	PROPN	acronym
at	ADV	abbreviation
aT	NOUN	acronym
A&T	PROPN	acronym
atk	NOUN	acronym
ATL	PROPN	acronym
atm	NOUN	acronym
ATS	NOUN	acronym
AT&T	PROPN	acronym
ATTAC	PROPN	acronym
au.	NOUN	abbreviation
AU	PROPN	acronym
AU$	NOUN	acronym
AUD	NOUN	acronym
AUK	NOUN	acronym
ausk.	NOUN	abbreviation
av	NOUN	acronym
aV	NOUN	acronym
AVEA	PROPN	acronym
AVI	NOUN	acronym
aW	NOUN	acronym
aWb	NOUN	acronym
AWG	NOUN	acronym
ay	NOUN	acronym
ay.	NOUN	abbreviation
AYO	PROPN	acronym
AZM	NOUN	acronym
AZN	NOUN	acronym
aΩ	NOUN	acronym
b	NOUN	acronym
B	NOUN	acronym
B9	PROPN	acronym
BA	NOUN	acronym
B.A.	NOUN	abbreviation
BAA	PROPN	acronym
BAD	NOUN	acronym
BAE	PROPN	acronym
BAIC	PROPN	acronym
BAM	NOUN	acronym
BAN	NOUN	acronym
bar	ADV	abbreviation
BASF	PROPN	acronym
BATS	PROPN	acronym
BayernLB	PROPN	acronym
B&B	NOUN	acronym
BBC	PROPN	acronym
BBD	NOUN	acronym
BB&T	PROPN	acronym
BBVA	PROPN	acronym
BD	NOUN	acronym
BDS$	NOUN	acronym
BDT	NOUN	acronym
Be	NOUN	acronym
BE	PROPN	acronym
BEA	NOUN	acronym
BEC	NOUN	acronym
BEF	NOUN	acronym
BEL	NOUN	acronym
Ber$	NOUN	acronym
BF	NOUN	acronym
BGL	NOUN	acronym
BGM	NOUN	acronym
BGN	NOUN	acronym
BGO	NOUN	acronym
BHD	NOUN	acronym
BHP	PROPN	acronym
BIF	NOUN	acronym
BIS	PROPN	acronym
BKK	PROPN	acronym
bkt	NOUN	acronym
BKT	NOUN	acronym
bktl	NOUN	acronym
Blue1	PROPN	acronym
BMD	NOUN	acronym
BMI	PROPN	acronym
BMW	PROPN	acronym
BMWi	PROPN	acronym
BND	NOUN	acronym
BOA	PROPN	acronym
B.o.B	PROPN	acronym
BOB	NOUN	acronym
BOJ	PROPN	acronym
BOL	NOUN	acronym
BOP	NOUN	acronym
BOV	NOUN	acronym
BP	PROPN	acronym
Bq	NOUN	acronym
br.	NOUN	abbreviation
Br	NOUN	acronym
BRB	NOUN	acronym
BRC	NOUN	acronym
BRE	NOUN	acronym
BRL	NOUN	acronym
BRN	NOUN	acronym
BRR	NOUN	acronym
brt	NOUN	acronym
BRZ	NOUN	acronym
Bs	NOUN	acronym
B.S.	NOUN	abbreviation
BSc	NOUN	acronym
B.Sc.	NOUN	abbreviation
BSD	NOUN	acronym
BSE	NOUN	acronym
BSkyB	PROPN	acronym
BT	PROPN	acronym
BTIG	PROPN	acronym
BTN	NOUN	acronym
BUK	NOUN	acronym
BWP	NOUN	acronym
BYB	NOUN	acronym
BYD	PROPN	acronym
BYR	NOUN	acronym
BZ$	NOUN	acronym
BZA	PROPN	acronym
BZD	NOUN	acronym
c	NOUN	acronym
C	NOUN	acronym
£C	NOUN	acronym
ca	ADV	abbreviation
c:a	ADV	abbreviation
cA	NOUN	acronym
C&A	PROPN	acronym
CA$	NOUN	acronym
CAD	NOUN	acronym
CAF	PROPN	acronym
cal	NOUN	acronym
Call99577	NOUN	acronym
CAM	NOUN	acronym
Can$	NOUN	acronym
Canal+	PROPN	acronym
CAT	NOUN	acronym
cBq	NOUN	acronym
CBS	PROPN	acronym
cc	NOUN	acronym
cC	NOUN	acronym
c°C	NOUN	acronym
CCCP	PROPN	acronym
ccd	NOUN	acronym
cd	NOUN	acronym
CD	NOUN	acronym
CDF	NOUN	acronym
cdma	NOUN	acronym
CD-R	NOUN	acronym
CD-ROM	NOUN	acronym
CD-RW	NOUN	acronym
CE	NOUN	acronym
CEA	NOUN	acronym
CECA	PROPN	acronym
CEFTA	PROPN	acronym
CEN	PROPN	acronym
CENTO	PROPN	acronym
CEP	PROPN	acronym
CEPS	PROPN	acronym
CERN	PROPN	acronym
CEVA/EGL	PROPN	acronym
cf.	NOUN	abbreviation
cF	NOUN	acronym
CF	NOUN	acronym
CFPF	NOUN	acronym
cg	NOUN	acronym
CGI	PROPN	acronym
cGy	NOUN	acronym
cH	NOUN	acronym
Ch$	NOUN	acronym
CHE	NOUN	acronym
CHF	NOUN	acronym
CHW	NOUN	acronym
cHz	NOUN	acronym
CIA	PROPN	acronym
CICA	PROPN	acronym
CIE	PROPN	acronym
CIHEC	PROPN	acronym
CIMO	PROPN	acronym
CINT	PROPN	acronym
CIOFF	PROPN	acronym
CIPD	PROPN	acronym
CISV	PROPN	acronym
CIT	PROPN	acronym
cJ	NOUN	acronym
cK	NOUN	acronym
ckat	NOUN	acronym
cl	NOUN	acronym
Cl	NOUN	acronym
CLE	NOUN	acronym
CLF	NOUN	acronym
clm	NOUN	acronym
CLP	NOUN	acronym
clx	NOUN	acronym
cm	NOUN	acronym
cmol	NOUN	acronym
cN	NOUN	acronym
CN	NOUN	acronym
CNBC	PROPN	acronym
CNN	PROPN	acronym
CNPC	PROPN	acronym
CNS	NOUN	acronym
CNX	NOUN	acronym
CNY	NOUN	acronym
c/o	ADV	abbreviation
Co	NOUN	acronym
Co.	NOUN	abbreviation
CO	NOUN	acronym
COD	NOUN	acronym
Col$	NOUN	acronym
COMP	NOUN	acronym
COP	NOUN	acronym
Corp	NOUN	acronym
Corp.	NOUN	abbreviation
COU	NOUN	acronym
cp	NOUN	acronym
cPa	NOUN	acronym
CPM	PROPN	acronym
CPW	PROPN	acronym
CR	NOUN	acronym
CRA	PROPN	acronym
crad	NOUN	acronym
CRC	NOUN	acronym
CRH	PROPN	acronym
cs	NOUN	acronym
cS	NOUN	acronym
CSA	PROPN	acronym
CSD	NOUN	acronym
CSK	NOUN	acronym
csr	NOUN	acronym
CSR	PROPN	acronym
cSv	NOUN	acronym
cT	NOUN	acronym
CT	NOUN	acronym
CTIA	PROPN	acronym
Cu	NOUN	acronym
CUC	NOUN	acronym
CUP	NOUN	acronym
cv	NOUN	acronym
cV	NOUN	acronym
CV	NOUN	acronym
CVE	NOUN	acronym
CVEsc	NOUN	acronym
cW	NOUN	acronym
cWb	NOUN	acronym
CYP	NOUN	acronym
CZ	NOUN	acronym
CZK	NOUN	acronym
cΩ	NOUN	acronym
d	NOUN	acronym
dA	NOUN	acronym
DA	NOUN	acronym
daA	NOUN	acronym
DAB	NOUN	acronym
daBq	NOUN	acronym
daC	NOUN	acronym
da°C	NOUN	acronym
dacd	NOUN	acronym
daF	NOUN	acronym
dag	NOUN	acronym
daGy	NOUN	acronym
daH	NOUN	acronym
daHz	NOUN	acronym
daJ	NOUN	acronym
daK	NOUN	acronym
dakat	NOUN	acronym
dalm	NOUN	acronym
dalx	NOUN	acronym
dam	NOUN	acronym
DAMA	PROPN	acronym
damol	NOUN	acronym
daN	NOUN	acronym
daPa	NOUN	acronym
darad	NOUN	acronym
das	NOUN	acronym
daS	NOUN	acronym
dasr	NOUN	acronym
daSv	NOUN	acronym
daT	NOUN	acronym
DAT	PROPN	acronym
daV	NOUN	acronym
daW	NOUN	acronym
daWb	NOUN	acronym
daΩ	NOUN	acronym
dB	NOUN	acronym
Db	NOUN	acronym
dBq	NOUN	acronym
DBRS	PROPN	acronym
dC	NOUN	acronym
d°C	NOUN	acronym
DC	NOUN	acronym
dcd	NOUN	acronym
DDB	PROPN	acronym
DDM	NOUN	acronym
DDR	PROPN	acronym
DDT	NOUN	acronym
DE	NOUN	acronym
dem.	NOUN	abbreviation
DEM	NOUN	acronym
den	NOUN	acronym
dF	NOUN	acronym
DF	NOUN	acronym
DFI	NOUN	acronym
dg	NOUN	acronym
DGB	PROPN	acronym
dGy	NOUN	acronym
dH	NOUN	acronym
DHL	PROPN	acronym
dHz	NOUN	acronym
DI	NOUN	acronym
DIN	PROPN	acronym
dipl.	NOUN	abbreviation
dipl.arkkit.	NOUN	abbreviation
dipl.ekon.	NOUN	abbreviation
dipl.ins.	NOUN	abbreviation
dipl.kielenk.	NOUN	abbreviation
dipl.kirjeenv.	NOUN	abbreviation
dipl.kosm.	NOUN	abbreviation
dipl.urk.	NOUN	abbreviation
div.	NOUN	abbreviation
dj	NOUN	acronym
dJ	NOUN	acronym
DJF	NOUN	acronym
dK	NOUN	acronym
DK	NOUN	acronym
dkat	NOUN	acronym
DKK	NOUN	acronym
DKr	NOUN	acronym
dl	NOUN	acronym
DLA	PROPN	acronym
dlm	NOUN	acronym
dlx	NOUN	acronym
dm	NOUN	acronym
DMA	NOUN	acronym
dmol	NOUN	acronym
dN	NOUN	acronym
dna	NOUN	acronym
DNA	PROPN	acronym
DNB	PROPN	acronym
dnro	NOUN	abbreviation
do	NOUN	acronym
DOP	NOUN	acronym
dos.	NOUN	abbreviation
DOS	PROPN	acronym
dPa	NOUN	acronym
DPA	NOUN	acronym
DPI	NOUN	acronym
Dr.	NOUN	abbreviation
drad	NOUN	acronym
DRAM	NOUN	acronym
ds	NOUN	acronym
dS	NOUN	acronym
dsr	NOUN	acronym
dSv	NOUN	acronym
dT	NOUN	acronym
DU	NOUN	acronym
dV	NOUN	acronym
dvd	NOUN	acronym
DVD	NOUN	acronym
dW	NOUN	acronym
dWb	NOUN	acronym
DZD	NOUN	acronym
dΩ	NOUN	acronym
e	NOUN	acronym
e.	NOUN	abbreviation
E	NOUN	acronym
EA	PROPN	acronym
eaa	ADV	abbreviation
eaa.	NOUN	abbreviation
EADS	PROPN	acronym
EAN	NOUN	acronym
EARTO	PROPN	acronym
EAY	PROPN	acronym
EBF	PROPN	acronym
EBq	NOUN	acronym
EBRD	PROPN	acronym
EBS	PROPN	acronym
EBU	PROPN	acronym
EC	NOUN	acronym
E°C	NOUN	acronym
EC$	NOUN	acronym
ECA	PROPN	acronym
ECADI	PROPN	acronym
Ecd	NOUN	acronym
Ecosoc	PROPN	acronym
ECR	PROPN	acronym
ECRI	PROPN	acronym
ECS	NOUN	acronym
ECSC	PROPN	acronym
ECU	NOUN	acronym
ECV	NOUN	acronym
ed.	NOUN	abbreviation
EDF	PROPN	acronym
EDI	NOUN	acronym
EE	NOUN	acronym
EEC	PROPN	acronym
eeg	NOUN	acronym
EEK	NOUN	acronym
EELA	PROPN	acronym
EF	NOUN	acronym
EFF	PROPN	acronym
EFTA	PROPN	acronym
e.g.	NOUN	abbreviation
Eg	NOUN	acronym
EGP	NOUN	acronym
EGy	NOUN	acronym
EH	NOUN	acronym
EHEC	NOUN	acronym
eht.	NOUN	abbreviation
Ehty	PROPN	acronym
EHTY	NOUN	acronym
EHz	NOUN	acronym
EICTA	PROPN	acronym
EIP	NOUN	acronym
EJ	NOUN	acronym
Ejustite.fr	PROPN	acronym
EK	PROPN	acronym
Ekat	NOUN	acronym
ekg	NOUN	acronym
EKK	PROPN	acronym
EKL	PROPN	acronym
ekon.	NOUN	abbreviation
EKP	PROPN	acronym
eKr	ADV	abbreviation
eKr.	NOUN	abbreviation
EKR	NOUN	acronym
EL	PROPN	acronym
eläinl.	NOUN	abbreviation
eläinlääket.	NOUN	abbreviation
eläk.	NOUN	abbreviation
ELDR	NOUN	acronym
Elektroni.fi	PROPN	acronym
elintarviket.	NOUN	abbreviation
ELK	NOUN	acronym
ELL	NOUN	acronym
el.lääk.	NOUN	abbreviation
Elm	NOUN	acronym
ELT	NOUN	acronym
ELTO	NOUN	acronym
Elx	NOUN	acronym
em.	NOUN	abbreviation
Em	NOUN	acronym
EM	PROPN	acronym
EMC	PROPN	acronym
EMEA	PROPN	acronym
EMG	NOUN	acronym
EMI	PROPN	acronym
Emol	NOUN	acronym
EMS	NOUN	acronym
emt.	NOUN	abbreviation
Emu	PROPN	acronym
EMU	PROPN	acronym
EMW	PROPN	acronym
EN	PROPN	acronym
ENEA	PROPN	acronym
ent.	NOUN	abbreviation
EOA	NOUN	acronym
EOAK	NOUN	acronym
E.ON	PROPN	acronym
eos.	NOUN	abbreviation
EOS	NOUN	acronym
EP	PROPN	acronym
EPa	NOUN	acronym
EPO	PROPN	acronym
eQ	PROPN	acronym
EQ	PROPN	acronym
EQT	PROPN	acronym
Erad	NOUN	acronym
erikoiseläinl.	NOUN	abbreviation
erikoishammasl.	NOUN	abbreviation
erikoisl.	NOUN	abbreviation
erikoist.	NOUN	abbreviation
ERM	PROPN	acronym
ERN	NOUN	acronym
ERTO	PROPN	acronym
ERVV	PROPN	acronym
Es	PROPN	acronym
ES	NOUN	acronym
ESA	PROPN	acronym
ESB	NOUN	acronym
esik.	NOUN	abbreviation
esim	ADV	abbreviation
esim.	NOUN	abbreviation
esitt.	NOUN	abbreviation
ESMA	PROPN	acronym
ESO	PROPN	acronym
ESP	NOUN	acronym
Esr	NOUN	acronym
ESR	PROPN	acronym
est.	NOUN	abbreviation
ESTIEM	PROPN	acronym
ESv	NOUN	acronym
ESY	NOUN	acronym
et.	NOUN	abbreviation
ET	NOUN	acronym
ETA	PROPN	acronym
ETB	NOUN	acronym
etc	ADV	abbreviation
etc.	NOUN	abbreviation
ETK	PROPN	acronym
ETL	PROPN	acronym
ETLA	PROPN	acronym
ETM	NOUN	acronym
ETSI	PROPN	acronym
ETSK	NOUN	acronym
ETT	PROPN	acronym
ETTA	PROPN	acronym
ETY	PROPN	acronym
ETYJ	PROPN	acronym
ETYK	PROPN	acronym
EU	PROPN	acronym
EU27	PROPN	acronym
EUR	NOUN	acronym
EUSTORY	PROPN	acronym
EUVL	NOUN	acronym
ev.	NOUN	abbreviation
eV	NOUN	acronym
EV	NOUN	acronym
EVA	PROPN	acronym
EveryDNS	PROPN	acronym
ev.lut.	NOUN	abbreviation
ev.luutn.	NOUN	abbreviation
EVM	PROPN	acronym
evp.	NOUN	abbreviation
EVR	PROPN	acronym
EVVK	NOUN	acronym
EW	NOUN	acronym
EWb	NOUN	acronym
EY	PROPN	acronym
EYVL	PROPN	acronym
EΩ	NOUN	acronym
f	NOUN	acronym
f.	NOUN	abbreviation
F	NOUN	acronym
F$	NOUN	acronym
fa	NOUN	acronym
fA	NOUN	acronym
FaK	NOUN	acronym
FaL	NOUN	acronym
FaM	NOUN	acronym
FAO	PROPN	acronym
FAQ	NOUN	acronym
farm.	NOUN	abbreviation
farmas.	NOUN	abbreviation
FaT	NOUN	acronym
FBI	PROPN	acronym
fBq	NOUN	acronym
Fbu	NOUN	acronym
fC	NOUN	acronym
f°C	NOUN	acronym
F&C	PROPN	acronym
fcd	NOUN	acronym
FCMA	PROPN	acronym
FDIC	PROPN	acronym
fF	NOUN	acronym
fg	NOUN	acronym
FGBMFI	PROPN	acronym
fGy	NOUN	acronym
fH	NOUN	acronym
fHz	NOUN	acronym
FI	PROPN	acronym
FIA	PROPN	acronym
FICIX	PROPN	acronym
FIFA	PROPN	acronym
fil.	NOUN	abbreviation
FILE	NOUN	acronym
FILI	PROPN	acronym
FIM	NOUN	acronym
FIMECC	PROPN	acronym
FIMIC	PROPN	acronym
FiMUG	PROPN	acronym
FIN	PROPN	acronym
FIT	PROPN	acronym
fJ	NOUN	acronym
FJD	NOUN	acronym
fK	NOUN	acronym
FK	NOUN	acronym
fkat	NOUN	acronym
FKP	NOUN	acronym
fl	NOUN	acronym
FL	NOUN	acronym
flm	NOUN	acronym
flx	NOUN	acronym
fm	NOUN	acronym
FM	NOUN	acronym
fmol	NOUN	acronym
fN	NOUN	acronym
Fonderie47	PROPN	acronym
fPa	NOUN	acronym
fr	NOUN	acronym
FR	NOUN	acronym
frad	NOUN	acronym
FRF	NOUN	acronym
fs	NOUN	acronym
fS	NOUN	acronym
fsr	NOUN	acronym
fSv	NOUN	acronym
ft.	NOUN	abbreviation
fT	NOUN	acronym
Ft	NOUN	acronym
FT	NOUN	acronym
FTAA	PROPN	acronym
FTP	NOUN	acronym
FUNET	NOUN	acronym
FUUG	PROPN	acronym
fV	NOUN	acronym
fW	NOUN	acronym
fWb	NOUN	acronym
fΩ	NOUN	acronym
g	NOUN	acronym
G	PROPN	acronym
G$	NOUN	acronym
G20	PROPN	acronym
G4S	PROPN	acronym
G77	PROPN	acronym
G8	PROPN	acronym
GA	NOUN	acronym
gal	NOUN	acronym
GATT	NOUN	acronym
GB	NOUN	acronym
GBP	NOUN	acronym
GBq	NOUN	acronym
GC	NOUN	acronym
G°C	NOUN	acronym
Gcd	NOUN	acronym
GCHQ	PROPN	acronym
GEA	NOUN	acronym
GEK	NOUN	acronym
GEL	NOUN	acronym
GEYSIR	PROPN	acronym
GF	NOUN	acronym
GfK	PROPN	acronym
Gg	NOUN	acronym
GGy	NOUN	acronym
GH	NOUN	acronym
GHC	NOUN	acronym
GHS	NOUN	acronym
GHz	NOUN	acronym
GIP	NOUN	acronym
GJ	NOUN	acronym
GK	NOUN	acronym
Gkat	NOUN	acronym
GL	PROPN	acronym
GLG	PROPN	acronym
Glm	NOUN	acronym
Glx	NOUN	acronym
gm	NOUN	acronym
Gm	NOUN	acronym
GM	PROPN	acronym
Gmbh	NOUN	acronym
GmbH	NOUN	acronym
GMD	NOUN	acronym
gmo	NOUN	acronym
GMO	PROPN	acronym
Gmol	NOUN	acronym
GN	NOUN	acronym
GNF	NOUN	acronym
GNS	NOUN	acronym
GodFm	PROPN	acronym
gon	NOUN	acronym
GP	NOUN	acronym
GPa	NOUN	acronym
GPRS	NOUN	acronym
GQE	NOUN	acronym
Grad	NOUN	acronym
GRD	NOUN	acronym
Gs	NOUN	acronym
GS	NOUN	acronym
GSM	NOUN	acronym
Gsr	NOUN	acronym
GSv	NOUN	acronym
Gt	ADV	abbreviation
GT	NOUN	acronym
GTi	PROPN	abbreviation
GTK	PROPN	acronym
GTQ	NOUN	acronym
GUAM	PROPN	acronym
GUE	NOUN	acronym
GV	NOUN	acronym
GW	NOUN	acronym
GWb	NOUN	acronym
GWE	NOUN	acronym
GWP	NOUN	acronym
Gy	NOUN	acronym
GYD	NOUN	acronym
GΩ	NOUN	acronym
h	NOUN	acronym
H	NOUN	acronym
ha	INTJ	acronym
hA	NOUN	acronym
HA	NOUN	acronym
hallinton.	NOUN	abbreviation
hallintot.	NOUN	abbreviation
hammaslääket.	NOUN	abbreviation
HAO	NOUN	acronym
HAUS	PROPN	acronym
Hb	NOUN	acronym
HBL	PROPN	acronym
HBO	PROPN	acronym
HBOS	PROPN	acronym
hBq	NOUN	acronym
h.c.	NOUN	abbreviation
hC	NOUN	acronym
h°C	NOUN	acronym
hcd	NOUN	acronym
HCL	PROPN	acronym
hdtv	NOUN	acronym
HE	NOUN	acronym
HEPA	NOUN	acronym
HETKY	PROPN	acronym
HEUNI	PROPN	acronym
hF	NOUN	acronym
HFU	PROPN	acronym
hg	NOUN	acronym
Hg	NOUN	acronym
hGy	NOUN	acronym
hh	INTJ	acronym
hH	NOUN	acronym
hHz	NOUN	acronym
HIFK	PROPN	acronym
HIIT	PROPN	acronym
HIM	PROPN	acronym
HITAS	NOUN	acronym
HIV	NOUN	acronym
hJ	NOUN	acronym
HJK	PROPN	acronym
hK	NOUN	acronym
HK	PROPN	acronym
HK$	NOUN	acronym
hkat	NOUN	acronym
HKD	NOUN	acronym
Hki	PROPN	abbreviation
HKL	PROPN	acronym
hl	NOUN	acronym
hl.	NOUN	abbreviation
HL	PROPN	acronym
HLK	NOUN	acronym
HLL	NOUN	acronym
hlm	NOUN	acronym
hlö	NOUN	abbreviation
HLT	NOUN	acronym
hlx	NOUN	acronym
hm	INTJ	acronym
HM	NOUN	acronym
H&M	PROPN	acronym
hmol	NOUN	acronym
HMV	PROPN	acronym
hN	NOUN	acronym
HN	NOUN	acronym
HNL	NOUN	acronym
HO	PROPN	acronym
HOAS	PROPN	acronym
HögforsGST	PROPN	acronym
hojks	NOUN	acronym
HOK	NOUN	acronym
HOP	PROPN	acronym
HOPS	NOUN	acronym
hovioik.	NOUN	abbreviation
hp.	NOUN	abbreviation
HP	PROPN	acronym
hPa	NOUN	acronym
HPE	NOUN	acronym
HQ	PROPN	acronym
hra	NOUN	abbreviation
hrad	NOUN	acronym
HRD	NOUN	acronym
HRK	NOUN	acronym
HRL	NOUN	acronym
hs	NOUN	acronym
hS	NOUN	acronym
HS	PROPN	acronym
HSBC	PROPN	acronym
HSE	PROPN	acronym
HSL	PROPN	acronym
hsr	NOUN	acronym
HST	NOUN	acronym
hsto	NOUN	abbreviation
hSv	NOUN	acronym
hT	NOUN	acronym
HT	PROPN	acronym
HTC	PROPN	acronym
HTG	NOUN	acronym
HTK	NOUN	acronym
htkk	NOUN	acronym
HTL	NOUN	acronym
HTM	NOUN	acronym
HTML	NOUN	acronym
HTT	NOUN	acronym
HTTP	NOUN	acronym
htv	NOUN	acronym
HUF	NOUN	acronym
HuK	NOUN	acronym
hum.	NOUN	abbreviation
huom	ADV	abbreviation
huom.	NOUN	abbreviation
HUS	PROPN	acronym
HUUGO	PROPN	acronym
hv	NOUN	acronym
hV	NOUN	acronym
H.V.	NOUN	abbreviation
HVK	PROPN	acronym
HVT	NOUN	acronym
hW	NOUN	acronym
hWb	NOUN	acronym
HY	PROPN	acronym
HYK	PROPN	acronym
HYKS	PROPN	acronym
HYLA	NOUN	acronym
HYY	PROPN	acronym
Hz	NOUN	acronym
hΩ	NOUN	acronym
i	NOUN	acronym
I	NOUN	acronym
IAAF	PROPN	acronym
IAEA	PROPN	acronym
IARC	PROPN	acronym
IATA	PROPN	acronym
IAU	PROPN	acronym
ib.	NOUN	abbreviation
IB	NOUN	acronym
IBBY	PROPN	acronym
ibid.	NOUN	abbreviation
IBM	PROPN	acronym
IBRD	PROPN	acronym
ICAP	PROPN	acronym
ICCROM	PROPN	acronym
ICOMOS	PROPN	acronym
ict	NOUN	acronym
id.	NOUN	abbreviation
ID	NOUN	acronym
IDC	PROPN	acronym
IDR	NOUN	acronym
i.e.	NOUN	abbreviation
IEA	PROPN	acronym
IEC	NOUN	acronym
IEEE	PROPN	acronym
IEP	NOUN	acronym
IFA	PROPN	acronym
IFK	PROPN	acronym
IHEYO	PROPN	acronym
IIF	PROPN	acronym
IKB	PROPN	acronym
IKI	PROPN	acronym
IKL	PROPN	acronym
ikt	NOUN	acronym
IL	PROPN	acronym
ILL	PROPN	acronym
ilm.	NOUN	abbreviation
ilmavE	NOUN	acronym
ILO	PROPN	acronym
ILP	NOUN	acronym
ILR	NOUN	acronym
ILS	NOUN	acronym
IMEKO	PROPN	acronym
IMF	PROPN	acronym
IMI	PROPN	acronym
in	ADV	abbreviation
in.	NOUN	abbreviation
inc	NOUN	acronym
inc.	NOUN	abbreviation
ING	PROPN	acronym
INR	NOUN	acronym
INRI	NOUN	acronym
ins.	NOUN	abbreviation
internet-tv	NOUN	acronym
ip.	NOUN	abbreviation
IP	NOUN	acronym
IPA	NOUN	acronym
IPEM	PROPN	acronym
IPU	PROPN	acronym
IQD	NOUN	acronym
IR£	NOUN	acronym
IRA	PROPN	acronym
IRC	NOUN	acronym
IRR	NOUN	acronym
IS	PROPN	acronym
ISAI	PROPN	acronym
ISBN	NOUN	acronym
ISDN	NOUN	acronym
ISEC	PROPN	acronym
ISJ	NOUN	acronym
ISK	NOUN	acronym
ISM	PROPN	acronym
ISMN	NOUN	acronym
ISO	PROPN	acronym
ISSN	NOUN	acronym
ISY	PROPN	acronym
it	NOUN	acronym
it.	NOUN	abbreviation
IT	NOUN	acronym
ITC	PROPN	acronym
ITE	NOUN	acronym
ITL	NOUN	acronym
ITT	PROPN	acronym
ITU	PROPN	acronym
IU	NOUN	acronym
i.v.	NOUN	abbreviation
IVO	PROPN	acronym
IVY	PROPN	acronym
IZT	PROPN	acronym
j	NOUN	acronym
J	NOUN	acronym
J$	NOUN	acronym
jaa	ADV	abbreviation
jaa.	NOUN	abbreviation
jääk.	NOUN	abbreviation
jälj.	NOUN	abbreviation
jatk.	NOUN	abbreviation
JBL	PROPN	acronym
JC	PROPN	acronym
JD	NOUN	acronym
JHL	PROPN	acronym
JHTT	NOUN	acronym
JIT	NOUN	acronym
Jk.	NOUN	abbreviation
JK	NOUN	acronym
jKr	ADV	abbreviation
jKr.	NOUN	abbreviation
jm	NOUN	acronym
JM	PROPN	acronym
JMD	NOUN	acronym
jms	ADV	abbreviation
jms.	NOUN	abbreviation
jne	ADV	abbreviation
jne.	NOUN	abbreviation
JOD	NOUN	acronym
joht.	NOUN	abbreviation
JOT	NOUN	acronym
JoY	PROPN	acronym
JPY	NOUN	acronym
jr.	NOUN	abbreviation
JS	NOUN	acronym
JSN	PROPN	acronym
JSW	PROPN	acronym
julk.	NOUN	abbreviation
JVC	PROPN	acronym
JVG	PROPN	acronym
JY	PROPN	acronym
JyP	PROPN	acronym
JYP	PROPN	acronym
k	NOUN	acronym
k.	NOUN	abbreviation
K	NOUN	acronym
K1	PROPN	acronym
K12	NOUN	acronym
K13	NOUN	acronym
K15	NOUN	acronym
K16	NOUN	acronym
K18	NOUN	acronym
ka	NOUN	acronym
ka.	NOUN	abbreviation
kA	NOUN	acronym
KA	PROPN	acronym
kad.	NOUN	abbreviation
KadK	PROPN	acronym
kal.	NOUN	abbreviation
kamr.	NOUN	abbreviation
kand.	NOUN	abbreviation
kansaned.	NOUN	abbreviation
kantt.	NOUN	abbreviation
KäO	NOUN	acronym
kappal.	NOUN	abbreviation
kapt.	NOUN	abbreviation
kapt.luutn.	NOUN	abbreviation
käsit.op.	NOUN	abbreviation
kasvatust.	NOUN	abbreviation
kat.	NOUN	abbreviation
KAT	NOUN	acronym
kats.	NOUN	abbreviation
KATTI	PROPN	acronym
kauppat.	NOUN	abbreviation
kb	NOUN	acronym
kB	NOUN	acronym
KBC	PROPN	acronym
kBq	NOUN	acronym
kC	NOUN	acronym
k°C	NOUN	acronym
kcal	ADV	abbreviation
kcd	NOUN	acronym
kd.	NOUN	abbreviation
KD	NOUN	acronym
ke	ADV	abbreviation
KEDO	PROPN	acronym
KEHO	PROPN	acronym
KEL	NOUN	acronym
KELA	PROPN	acronym
kenr.	NOUN	abbreviation
kenr.luutn.	NOUN	abbreviation
kenr.maj.	NOUN	abbreviation
Kenttäurheilijat-58	PROPN	acronym
KEPA	PROPN	acronym
kers.	NOUN	abbreviation
KES	NOUN	acronym
kesk.	ADV	abbreviation
Kesk.	NOUN	abbreviation
kF	NOUN	acronym
KFC	PROPN	acronym
KFOR	PROPN	acronym
kg	NOUN	acronym
KGB	PROPN	acronym
KGS	NOUN	acronym
kGy	NOUN	acronym
kh	NOUN	acronym
kh.	NOUN	abbreviation
kH	NOUN	acronym
KHK	NOUN	acronym
KHO	PROPN	acronym
KHR	NOUN	acronym
khra	NOUN	abbreviation
KHT	NOUN	acronym
kHz	NOUN	acronym
KIE	PROPN	acronym
KiEL	NOUN	acronym
kiint.oy	NOUN	acronym
kiint.oy.	NOUN	abbreviation
kiir.	NOUN	abbreviation
kir.	NOUN	abbreviation
kirj.	NOUN	abbreviation
kirjeenv.	NOUN	abbreviation
KiSV	PROPN	acronym
KIVI	PROPN	acronym
kj.	NOUN	abbreviation
kJ	NOUN	acronym
kk	NOUN	acronym
kk.	NOUN	abbreviation
kK	NOUN	acronym
KK	NOUN	acronym
kkat	NOUN	acronym
KKH	PROPN	acronym
KKK	PROPN	acronym
kko	NOUN	acronym
KKO	NOUN	acronym
KKOY	PROPN	acronym
kkp	NOUN	acronym
KKR	PROPN	acronym
kl.	NOUN	abbreviation
KL	NOUN	acronym
klm	NOUN	acronym
KLM	PROPN	acronym
klo	NOUN	abbreviation
KLT	NOUN	acronym
klx	NOUN	acronym
km	NOUN	acronym
KM	NOUN	acronym
k-m²	NOUN	acronym
k-m³	NOUN	acronym
KMF	NOUN	acronym
km/h	ADV	abbreviation
KMN	PROPN	acronym
kmol	NOUN	acronym
kN	NOUN	acronym
kni	NOUN	abbreviation
ko.	NOUN	abbreviation
KO	PROPN	acronym
kok.	ADV	abbreviation
Kok.	NOUN	abbreviation
KOK	PROPN	acronym
kokonais-DNA	NOUN	acronym
kom.	NOUN	abbreviation
KOM	NOUN	acronym
kom.kapt.	NOUN	abbreviation
komm.	NOUN	abbreviation
kompp.	NOUN	abbreviation
konst.	NOUN	abbreviation
kop	INTJ	acronym
KOP	PROPN	acronym
korpr.	NOUN	abbreviation
Korutrahaksi.fi	PROPN	acronym
kotital.op.	NOUN	abbreviation
kotiteoll.op.	NOUN	abbreviation
KOY	NOUN	acronym
kp	NOUN	acronym
kp.	NOUN	abbreviation
kPa	NOUN	acronym
kpl	NOUN	acronym
kpm	NOUN	acronym
KPMG	PROPN	acronym
KPN	PROPN	acronym
KPT	PROPN	acronym
KPW	NOUN	acronym
kr	NOUN	acronym
krad	NOUN	acronym
KRH	NOUN	acronym
krist.	NOUN	abbreviation
krj	NOUN	acronym
krnro	NOUN	abbreviation
KRO	NOUN	acronym
KRP	NOUN	acronym
krs	NOUN	acronym
KRW	NOUN	acronym
ks	NOUN	acronym
ks.	NOUN	abbreviation
kS	NOUN	acronym
KSO	PROPN	acronym
ksr	NOUN	acronym
kSv	NOUN	acronym
kt	NOUN	acronym
kT	NOUN	acronym
KT	NOUN	acronym
KtaO	NOUN	acronym
KteO	NOUN	acronym
KTK	PROPN	acronym
KTL	PROPN	acronym
KTM	NOUN	acronym
KTP	PROPN	acronym
KTS	NOUN	acronym
KTT	NOUN	acronym
KTTO	PROPN	acronym
KTV	PROPN	acronym
KtyO	NOUN	acronym
KU	PROPN	acronym
KUA	NOUN	acronym
Kultarahaksi.fi	PROPN	acronym
kumpp.	NOUN	abbreviation
KuPS	PROPN	acronym
kuv.	NOUN	abbreviation
KUV	PROPN	acronym
KuvA	PROPN	acronym
KuvO	NOUN	acronym
kuv.op.	NOUN	abbreviation
kv.	NOUN	abbreviation
kV	NOUN	acronym
KVL	PROPN	acronym
KVT	NOUN	acronym
KVTEL	NOUN	acronym
kvv	NOUN	acronym
kW	NOUN	acronym
kWb	NOUN	acronym
KWD	NOUN	acronym
kWh	NOUN	acronym
KWH	PROPN	acronym
ky	NOUN	acronym
ky.	NOUN	abbreviation
KYD	NOUN	acronym
KyO	PROPN	acronym
KYS	PROPN	acronym
KZT	NOUN	acronym
kΩ	NOUN	acronym
l	NOUN	acronym
l.	NOUN	abbreviation
L	NOUN	acronym
L2	NOUN	acronym
la	ADV	abbreviation
LA	NOUN	acronym
lääk.	NOUN	abbreviation
lääket.	NOUN	abbreviation
LAFTA	PROPN	acronym
läh.	NOUN	abbreviation
LaK	NOUN	acronym
LAK	NOUN	acronym
lakit.	NOUN	abbreviation
LaL	NOUN	acronym
länt.	NOUN	abbreviation
lastent.op.	NOUN	abbreviation
LaT	NOUN	acronym
LBP	NOUN	acronym
LD	NOUN	acronym
leht.	NOUN	abbreviation
lehtiö-pc	NOUN	acronym
LEL	NOUN	acronym
LEOPS	NOUN	acronym
LG	PROPN	acronym
LGT	PROPN	acronym
LH	NOUN	acronym
LI	NOUN	acronym
LIA	PROPN	acronym
liikuntak.	NOUN	abbreviation
liikuntat.	NOUN	abbreviation
LiK	NOUN	acronym
lis.	NOUN	abbreviation
LitK	NOUN	acronym
LitL	NOUN	acronym
LitM	NOUN	acronym
LitT	NOUN	acronym
lk.	NOUN	abbreviation
LK	NOUN	acronym
LKAB	PROPN	acronym
LKH	NOUN	acronym
LKK	PROPN	acronym
lkm.	NOUN	abbreviation
LKP	PROPN	acronym
LKR	NOUN	acronym
LKT	NOUN	acronym
lkv.	NOUN	abbreviation
LKV	NOUN	acronym
lky	NOUN	acronym
lky.	NOUN	abbreviation
ll	NOUN	acronym
ll.	NOUN	abbreviation
LL	NOUN	acronym
LLC	PROPN	acronym
lm	NOUN	acronym
lm.	NOUN	abbreviation
Lm	NOUN	acronym
LMFAO	NOUN	acronym
LO	PROPN	acronym
LOGY	PROPN	acronym
LOK	NOUN	acronym
Lp	NOUN	acronym
LP	NOUN	acronym
LPI	NOUN	acronym
LRD	NOUN	acronym
LS	NOUN	acronym
lsd	NOUN	acronym
LSL	NOUN	acronym
LSO	PROPN	acronym
LT	PROPN	acronym
LTCM	PROPN	acronym
ltd.	NOUN	abbreviation
LTE	PROPN	acronym
ltk	NOUN	acronym
ltk.	NOUN	abbreviation
LTL	NOUN	acronym
LTO	NOUN	acronym
LTS	NOUN	acronym
LTT	PROPN	acronym
LTY	PROPN	acronym
LUC	NOUN	acronym
LUF	PROPN	acronym
LuK	NOUN	acronym
LUL	NOUN	acronym
LUMA	NOUN	acronym
luonnont.	NOUN	abbreviation
lut.	NOUN	abbreviation
LUTU	NOUN	acronym
luutn.	NOUN	abbreviation
lv.	NOUN	abbreviation
lvi	NOUN	acronym
LVL	NOUN	acronym
LVM	NOUN	acronym
LVMH	PROPN	acronym
LVR	NOUN	acronym
lvv.	NOUN	abbreviation
lx	NOUN	acronym
ly	NOUN	acronym
LY	PROPN	acronym
LYD	NOUN	acronym
lyh.	NOUN	abbreviation
LYHKI	NOUN	acronym
m	NOUN	acronym
µm	NOUN	acronym
M	NOUN	acronym
M.	PROPN	abbreviation
m²	NOUN	acronym
m³	NOUN	acronym
ma.	NOUN	abbreviation
mA	NOUN	acronym
MA	NOUN	acronym
M.A.	NOUN	abbreviation
maan.	NOUN	abbreviation
maat.	NOUN	abbreviation
MAD	NOUN	acronym
MAF	NOUN	acronym
MAI	NOUN	acronym
Mail.ru	PROPN	acronym
maist.	NOUN	abbreviation
maj.	NOUN	abbreviation
maks.	NOUN	abbreviation
MAMU	NOUN	acronym
MAN	PROPN	acronym
MaO	NOUN	acronym
MAOL	PROPN	acronym
MAT	NOUN	acronym
matr.	NOUN	abbreviation
Mb	NOUN	acronym
MB	NOUN	acronym
MBA	NOUN	acronym
M.B.A	NOUN	acronym
MBA.	NOUN	abbreviation
MBD	NOUN	acronym
Mbit	NOUN	acronym
Mbit/s	NOUN	acronym
MBO	NOUN	acronym
Mbps	NOUN	acronym
mBq	NOUN	acronym
MBq	NOUN	acronym
Mb/s	NOUN	acronym
mC	NOUN	acronym
m°C	NOUN	acronym
MC	NOUN	acronym
M°C	NOUN	acronym
mcd	NOUN	acronym
Mcd	NOUN	acronym
MCF	NOUN	acronym
MDC	NOUN	acronym
MDen	NOUN	acronym
MDL	NOUN	acronym
MDU	PROPN	acronym
ME	NOUN	acronym
media-pc	NOUN	acronym
Medi-It	PROPN	acronym
MEK	PROPN	acronym
MEL	NOUN	acronym
MEMC	PROPN	acronym
MEP	NOUN	acronym
Mercedes-AMG	PROPN	acronym
MerivE	PROPN	acronym
merkon.	NOUN	abbreviation
METLA	PROPN	acronym
METO	PROPN	acronym
MetroPCS	PROPN	acronym
metsänhoit.	NOUN	abbreviation
metsät.	NOUN	abbreviation
MEUR	NOUN	acronym
MEX$	NOUN	acronym
mF	NOUN	acronym
MF	NOUN	acronym
mg	NOUN	acronym
Mg	NOUN	acronym
MG	PROPN	acronym
MGA	NOUN	acronym
MGF	NOUN	acronym
MGM	PROPN	acronym
mGy	NOUN	acronym
MGy	NOUN	acronym
mH	NOUN	acronym
MH	PROPN	acronym
mhy.	NOUN	abbreviation
mHz	NOUN	acronym
MHz	NOUN	acronym
mi	ADV	acronym
MI	NOUN	acronym
miel.	NOUN	abbreviation
MIGRI	PROPN	acronym
MIKES	PROPN	acronym
milj.	NOUN	abbreviation
min	NOUN	acronym
min.	NOUN	abbreviation
Miss	ADV	abbreviation
MIT	PROPN	acronym
mJ	NOUN	acronym
MJ	NOUN	acronym
mk	NOUN	acronym
mK	NOUN	acronym
MK	NOUN	acronym
mkat	NOUN	acronym
Mkat	NOUN	acronym
MKD	NOUN	acronym
MKH	PROPN	acronym
MKL	PROPN	acronym
MKN	NOUN	acronym
MKT	NOUN	acronym
ml	NOUN	acronym
ml.	NOUN	abbreviation
ML	PROPN	acronym
MLF	NOUN	acronym
mlk.	NOUN	abbreviation
Mlle	ADV	abbreviation
mlm	NOUN	acronym
Mlm	NOUN	acronym
mlx	NOUN	acronym
Mlx	NOUN	acronym
mm	NOUN	abbreviation
mm.	NOUN	abbreviation
Mm	NOUN	acronym
MM	NOUN	acronym
Mme	ADV	abbreviation
mmHg	NOUN	acronym
Mmk	NOUN	acronym
MMK	NOUN	acronym
MML	PROPN	acronym
MMM	NOUN	acronym
mmol	NOUN	acronym
Mmol	NOUN	acronym
MMT	NOUN	acronym
MMYL	PROPN	acronym
mN	NOUN	acronym
MN	NOUN	acronym
MNT	NOUN	acronym
MO	NOUN	acronym
mol	NOUN	acronym
mom.	NOUN	abbreviation
MOP	NOUN	acronym
mot	ADV	abbreviation
mot.	NOUN	abbreviation
mp.	NOUN	abbreviation
mp3	NOUN	acronym
MP3	NOUN	acronym
mPa	NOUN	acronym
MPa	NOUN	acronym
MPEG	NOUN	acronym
mpk	NOUN	acronym
MpKK	PROPN	acronym
mpm	ADV	abbreviation
mpm.	NOUN	abbreviation
MpO	PROPN	acronym
MPS	PROPN	acronym
Mpx	NOUN	acronym
mpy.	NOUN	abbreviation
MQ	PROPN	acronym
Mr	ADV	abbreviation
Mr.	NOUN	abbreviation
MR	PROPN	acronym
mrad	NOUN	acronym
Mrad	NOUN	acronym
mrd.	NOUN	abbreviation
MRO	NOUN	acronym
Mrs	ADV	abbreviation
ms	NOUN	acronym
m/s	NOUN	acronym
mS	NOUN	acronym
Ms	NOUN	abbreviation
MS	NOUN	acronym
MSB	PROPN	acronym
MSc	NOUN	acronym
M.Sc.	NOUN	abbreviation
MSCI	PROPN	acronym
MSD	PROPN	acronym
MSK	PROPN	acronym
msr	NOUN	acronym
Msr	NOUN	acronym
msrk.	NOUN	abbreviation
mSv	NOUN	acronym
MSv	NOUN	acronym
mt.	NOUN	abbreviation
mT	NOUN	acronym
Mt	NOUN	acronym
MT	NOUN	acronym
MTI	NOUN	acronym
MTK	PROPN	acronym
MTL	PROPN	acronym
MTN	PROPN	acronym
MTP	NOUN	acronym
mts.	NOUN	abbreviation
Mt/s	NOUN	acronym
MTS	PROPN	acronym
MTT	PROPN	acronym
MTV	PROPN	acronym
MTV3	PROPN	acronym
MuK	NOUN	acronym
MuL	NOUN	acronym
MuM	NOUN	acronym
MUR	NOUN	acronym
mus.	NOUN	abbreviation
mus.op.	NOUN	abbreviation
MuT	NOUN	acronym
mv.	NOUN	abbreviation
mV	NOUN	acronym
MV	NOUN	acronym
MVR	NOUN	acronym
mvs.	NOUN	abbreviation
mW	NOUN	acronym
MW	NOUN	acronym
mWb	NOUN	acronym
MWb	NOUN	acronym
MWh	NOUN	acronym
MWK	NOUN	acronym
MXN	NOUN	acronym
MXP	NOUN	acronym
MXV	NOUN	acronym
MYEL	NOUN	acronym
myöh.	NOUN	abbreviation
MYR	NOUN	acronym
MySQL	PROPN	acronym
MYY	PROPN	acronym
MZE	NOUN	acronym
MZM	NOUN	acronym
MZN	NOUN	acronym
mΩ	NOUN	acronym
MΩ	NOUN	acronym
n	NOUN	acronym
n.	NOUN	abbreviation
N	NOUN	acronym
N$	NOUN	acronym
nA	NOUN	acronym
NAD	NOUN	acronym
NAFTA	PROPN	acronym
NASA	PROPN	acronym
NATO	PROPN	acronym
N.B.	NOUN	abbreviation
NBC	PROPN	acronym
NBG	PROPN	acronym
nBq	NOUN	acronym
nC	NOUN	acronym
n°C	NOUN	acronym
NCC	PROPN	acronym
ncd	NOUN	acronym
NDX	PROPN	acronym
NEA	PROPN	acronym
NEC	PROPN	acronym
NESU-KY	PROPN	acronym
netti-tv	NOUN	acronym
neuv.	NOUN	abbreviation
nF	NOUN	acronym
ng	NOUN	acronym
NGN	NOUN	acronym
nGy	NOUN	acronym
nH	NOUN	acronym
NHL	PROPN	acronym
nHz	NOUN	acronym
NIB	PROPN	acronym
NIC	NOUN	acronym
nid.	NOUN	abbreviation
nim.	NOUN	abbreviation
nimim.	NOUN	abbreviation
NIO	NOUN	acronym
nJ	NOUN	acronym
nk.	NOUN	abbreviation
nK	NOUN	acronym
nkat	NOUN	acronym
NKP	PROPN	acronym
Nkr	NOUN	acronym
NKr	NOUN	acronym
NKT	NOUN	acronym
NL	PROPN	acronym
NLG	NOUN	acronym
nlm	NOUN	acronym
NLP	NOUN	acronym
nlx	NOUN	acronym
nm	NOUN	acronym
Nm	NOUN	acronym
NMKY	PROPN	acronym
nmol	NOUN	acronym
NMT	NOUN	acronym
nN	NOUN	acronym
NN	PROPN	acronym
N.N.	NOUN	abbreviation
NNKY	PROPN	acronym
n:o	NOUN	abbreviation
NOK	NOUN	acronym
Norcar-BSB	PROPN	acronym
NordLB	PROPN	acronym
nPa	NOUN	acronym
NPC	PROPN	acronym
NPR	NOUN	acronym
NRA	PROPN	acronym
nrad	NOUN	acronym
nro	ADV	abbreviation
Nrs	NOUN	acronym
nrt	NOUN	acronym
NRW	PROPN	acronym
ns	NOUN	abbreviation
ns.	NOUN	abbreviation
nS	NOUN	acronym
NSA	PROPN	acronym
NSN	PROPN	acronym
nsr	NOUN	acronym
nSv	NOUN	acronym
nT	NOUN	acronym
NT$	NOUN	acronym
NTB	PROPN	acronym
nti	ADV	abbreviation
NTP	PROPN	acronym
Nu	NOUN	acronym
NUVA	PROPN	acronym
nV	NOUN	acronym
NV	NOUN	acronym
NVL	PROPN	acronym
nW	NOUN	acronym
nWb	NOUN	acronym
nyk.	NOUN	abbreviation
$NZ	NOUN	acronym
NZ$	NOUN	acronym
NZD	NOUN	acronym
nΩ	NOUN	acronym
o	NOUN	acronym
O	NOUN	acronym
ö	INTJ	acronym
Ö	PROPN	acronym
O2	PROPN	acronym
oa.	NOUN	abbreviation
OAJ	PROPN	acronym
OAS	PROPN	acronym
obs	ADV	abbreviation
obs.	NOUN	abbreviation
OECD	PROPN	acronym
OEEC	PROPN	acronym
ÖFN	PROPN	acronym
oh.	NOUN	abbreviation
OIE	PROPN	acronym
oik.	NOUN	abbreviation
oikeust.	NOUN	abbreviation
OIKOS	PROPN	acronym
ok	ADV	acronym
ok.	NOUN	abbreviation
OK	NOUN	acronym
OKM	NOUN	acronym
OKV	PROPN	acronym
OLAF	PROPN	acronym
OLL	PROPN	acronym
OLPC	PROPN	acronym
om.	NOUN	abbreviation
OM	NOUN	acronym
OMD	PROPN	acronym
om.p.	NOUN	abbreviation
OMR	NOUN	acronym
OMX	PROPN	acronym
op	NOUN	acronym
op.	NOUN	abbreviation
OPEC	PROPN	acronym
opett.	NOUN	abbreviation
OPH	PROPN	acronym
OPK	PROPN	acronym
OPKK	PROPN	acronym
OPKO	PROPN	acronym
OPM	NOUN	acronym
OPO	NOUN	acronym
opp.	NOUN	abbreviation
OPS	NOUN	acronym
OPTL	PROPN	acronym
Oriola-KD	PROPN	acronym
ork.	NOUN	abbreviation
ortod.	NOUN	abbreviation
o.s.	NOUN	abbreviation
os.	NOUN	abbreviation
OS	NOUN	acronym
osk	NOUN	acronym
osk.	NOUN	abbreviation
OSKE	PROPN	acronym
OSMA	NOUN	acronym
OSTIV	PROPN	acronym
OTC	NOUN	acronym
OTE	PROPN	acronym
OTK	NOUN	acronym
OTL	NOUN	acronym
oto	NOUN	acronym
oto.	NOUN	abbreviation
OTT	NOUN	acronym
OÜ	NOUN	acronym
ov	NOUN	acronym
ovh	NOUN	acronym
ovh.	NOUN	abbreviation
OVT	NOUN	acronym
oy	NOUN	acronym
oy.	NOUN	abbreviation
OY	PROPN	acronym
oyj	NOUN	acronym
oyj.	NOUN	abbreviation
OYS	PROPN	acronym
oz.	NOUN	abbreviation
p	NOUN	acronym
p.	NOUN	abbreviation
P	NOUN	acronym
pa.	NOUN	abbreviation
pA	NOUN	acronym
Pa	NOUN	acronym
PA	NOUN	acronym
pääll.	NOUN	abbreviation
PAB	NOUN	acronym
PAH	NOUN	acronym
pak	NOUN	acronym
pakk	NOUN	acronym
PAM	PROPN	acronym
PAND	PROPN	acronym
paneeli-pc	NOUN	acronym
par.	NOUN	abbreviation
past.	NOUN	abbreviation
pat.	NOUN	abbreviation
patl.	NOUN	abbreviation
PAU	PROPN	acronym
PAV	NOUN	acronym
PAY	PROPN	acronym
pBq	NOUN	acronym
PBq	NOUN	acronym
pc	NOUN	acronym
pC	NOUN	acronym
p°C	NOUN	acronym
PC	NOUN	acronym
P°C	NOUN	acronym
PCB	NOUN	acronym
pcd	NOUN	acronym
Pcd	NOUN	acronym
PCUF	PROPN	acronym
pda	NOUN	acronym
PDA	NOUN	acronym
pdf	NOUN	acronym
PDF	NOUN	acronym
PDT	NOUN	acronym
PDVSA	PROPN	acronym
pe	ADV	abbreviation
PE	NOUN	acronym
PEI	NOUN	acronym
PEN	NOUN	acronym
per.	NOUN	abbreviation
perj.	NOUN	abbreviation
perusk.op.	NOUN	abbreviation
PES	NOUN	acronym
PET	NOUN	acronym
pF	NOUN	acronym
PF	NOUN	acronym
pg	NOUN	acronym
Pg	NOUN	acronym
PGE	PROPN	acronym
PGK	NOUN	acronym
pGy	NOUN	acronym
PGy	NOUN	acronym
ph.	NOUN	abbreviation
pH	NOUN	acronym
PH	NOUN	acronym
PhD	NOUN	acronym
Ph.D.	NOUN	abbreviation
PHP	NOUN	acronym
PHS	PROPN	acronym
PHS/TBWA	PROPN	acronym
pHz	NOUN	acronym
PHz	NOUN	acronym
pien-pc	NOUN	acronym
PIN	NOUN	acronym
pinta-WWW	NOUN	acronym
pion.	NOUN	abbreviation
PISA	NOUN	acronym
pit.	NOUN	abbreviation
pj	NOUN	acronym
pj.	NOUN	abbreviation
pJ	NOUN	acronym
PJ	NOUN	acronym
pjsto	NOUN	abbreviation
pk.	NOUN	abbreviation
pK	NOUN	acronym
PK	NOUN	acronym
pkat	NOUN	acronym
Pkat	NOUN	acronym
PKC	PROPN	acronym
PkO	NOUN	acronym
PKR	NOUN	acronym
pkt	NOUN	acronym
pl	NOUN	acronym
pl.	NOUN	abbreviation
PL	NOUN	acronym
plc	NOUN	acronym
plm	NOUN	acronym
Plm	NOUN	acronym
PLM	NOUN	acronym
PLN	NOUN	acronym
PLO	PROPN	acronym
plx	NOUN	acronym
Plx	NOUN	acronym
PLZ	NOUN	acronym
pm	NOUN	acronym
p.m.	NOUN	abbreviation
pm.	NOUN	abbreviation
Pm	NOUN	acronym
PM	NOUN	acronym
PMI	PROPN	acronym
pmm	NOUN	acronym
PMMP	PROPN	acronym
pmol	NOUN	acronym
Pmol	NOUN	acronym
pms	NOUN	acronym
pN	NOUN	acronym
PN	PROPN	acronym
pnä	ADV	abbreviation
pnk	NOUN	acronym
po.	NOUN	abbreviation
pohj.	NOUN	abbreviation
Polamk	PROPN	acronym
POP	PROPN	acronym
pp.	NOUN	abbreviation
PP	NOUN	acronym
pPa	NOUN	acronym
PPa	NOUN	acronym
PPE	NOUN	acronym
PPE-DE	NOUN	acronym
PPI	NOUN	acronym
ppm	NOUN	acronym
PPO	PROPN	acronym
PPR	PROPN	acronym
pr	NOUN	acronym
PR	NOUN	acronym
Pra	NOUN	acronym
prad	NOUN	acronym
Prad	NOUN	acronym
PRH	NOUN	acronym
prik.	NOUN	abbreviation
prk	NOUN	acronym
prof.	NOUN	abbreviation
prok.	NOUN	abbreviation
ProSiebenSat1	PROPN	acronym
prov.	NOUN	abbreviation
PRT	PROPN	acronym
ps	NOUN	acronym
ps.	NOUN	abbreviation
pS	NOUN	acronym
Ps	NOUN	acronym
PS	PROPN	acronym
P.S.	NOUN	abbreviation
PSA	PROPN	acronym
PSE	NOUN	acronym
PsK	NOUN	acronym
PsL	NOUN	acronym
PsM	NOUN	acronym
PSOAS	PROPN	acronym
PSOP	PROPN	acronym
PSP	PROPN	acronym
psr	NOUN	acronym
Psr	NOUN	acronym
PsT	NOUN	acronym
psta	ADV	abbreviation
psto	NOUN	abbreviation
pSv	NOUN	acronym
PSv	NOUN	acronym
psykol.	NOUN	abbreviation
pT	NOUN	acronym
PT	PROPN	acronym
PTE	NOUN	acronym
ptk.	NOUN	abbreviation
PTO	NOUN	acronym
ptri	NOUN	abbreviation
PTS	NOUN	acronym
PTT	PROPN	acronym
puh.	NOUN	abbreviation
puh.joht.	NOUN	abbreviation
pursim.	NOUN	abbreviation
puutarhaop.	NOUN	abbreviation
pv	NOUN	acronym
pv.	NOUN	abbreviation
pV	NOUN	acronym
PV	NOUN	acronym
pvc	NOUN	acronym
pvm.	NOUN	abbreviation
PvTK	PROPN	acronym
pW	NOUN	acronym
PW	NOUN	acronym
pWb	NOUN	acronym
PWb	NOUN	acronym
PwC	PROPN	acronym
PYG	NOUN	acronym
pΩ	NOUN	acronym
PΩ	NOUN	acronym
q	NOUN	acronym
Q	NOUN	acronym
QAR	NOUN	acronym
QR	NOUN	acronym
r	NOUN	acronym
r.	NOUN	abbreviation
R	NOUN	acronym
R$	NOUN	acronym
RAC	PROPN	acronym
rad	NOUN	acronym
rak.	NOUN	abbreviation
RAKLI	PROPN	acronym
rak.mest.	NOUN	abbreviation
RAM	NOUN	acronym
RAY	NOUN	acronym
RBC	PROPN	acronym
Rbl	NOUN	acronym
RBS	PROPN	acronym
RD$	NOUN	acronym
re	NOUN	acronym
Re.	NOUN	abbreviation
reht.	NOUN	abbreviation
rek.	NOUN	abbreviation
rek.nro	NOUN	acronym
rek.tn	NOUN	acronym
REM	NOUN	acronym
Repsol-YPF	PROPN	acronym
res.	NOUN	abbreviation
RFSU	PROPN	acronym
RHD	NOUN	acronym
RHJ	PROPN	acronym
RI	PROPN	acronym
R&I	NOUN	acronym
RIM	PROPN	acronym
rkl	NOUN	acronym
rkm.	NOUN	abbreviation
RKP	NOUN	acronym
Rkr	NOUN	acronym
RKT	NOUN	acronym
RKTL	PROPN	acronym
rl	NOUN	acronym
RL	NOUN	acronym
RM	NOUN	acronym
rna	NOUN	acronym
RN:o	NOUN	abbreviation
RO	PROPN	acronym
ROL	NOUN	acronym
ROM	NOUN	acronym
RON	NOUN	acronym
RoPS	PROPN	acronym
rov.	NOUN	abbreviation
rp.	ADV	abbreviation
Rp	NOUN	acronym
RP	PROPN	acronym
rpl	NOUN	acronym
rs	NOUN	acronym
r/s	NOUN	acronym
Rs.	NOUN	abbreviation
RSA	NOUN	acronym
RSD	NOUN	acronym
rsi	NOUN	acronym
RSS	NOUN	acronym
R.S.V.P.	NOUN	abbreviation
rt	NOUN	acronym
RTE	PROPN	acronym
rtg	NOUN	acronym
rtg.	NOUN	abbreviation
RTL	PROPN	acronym
RTS	PROPN	acronym
RU	PROPN	acronym
RUB	NOUN	acronym
RUK	PROPN	acronym
RUR	NOUN	acronym
RUS	PROPN	acronym
rva	NOUN	abbreviation
RVL	PROPN	acronym
RVLE	NOUN	acronym
RWE	PROPN	acronym
RWF	NOUN	acronym
RWI	PROPN	acronym
ry	NOUN	acronym
ry.	NOUN	abbreviation
rykm.	NOUN	abbreviation
s	NOUN	acronym
s.	NOUN	abbreviation
S	NOUN	acronym
S$	NOUN	acronym
š	NOUN	acronym
Š	NOUN	acronym
s2	NOUN	acronym
s:a	ADV	abbreviation
SA	NOUN	acronym
SAAB	PROPN	acronym
SaaS	NOUN	acronym
SAE	PROPN	acronym
SAFA	PROPN	acronym
sähköp.	NOUN	abbreviation
SAIC	PROPN	acronym
sairaanh.op.	NOUN	abbreviation
sair.hoit.	NOUN	abbreviation
SAJ	PROPN	acronym
SAK	PROPN	acronym
S.A.L.I	PROPN	acronym
SAMOK	PROPN	acronym
SAP	PROPN	acronym
SAR	NOUN	acronym
SAS	PROPN	acronym
SASK	NOUN	acronym
SatKS	PROPN	acronym
SatO	PROPN	acronym
SATS	PROPN	acronym
SATU	PROPN	acronym
säv.	NOUN	abbreviation
SavO	PROPN	acronym
SBAB	PROPN	acronym
SBD	NOUN	acronym
SBS	PROPN	acronym
SCA	PROPN	acronym
SCR	NOUN	acronym
s.d.	NOUN	abbreviation
sd.	NOUN	abbreviation
SDD	NOUN	acronym
SDG	NOUN	acronym
Sdp	NOUN	acronym
SDP	NOUN	acronym
SE	NOUN	acronym
SEA	PROPN	acronym
SEB	PROPN	acronym
SEC	PROPN	acronym
SEFE	PROPN	acronym
SEK	NOUN	acronym
SEL	PROPN	acronym
SELMU	PROPN	acronym
SEPA	NOUN	acronym
SESKO	PROPN	acronym
SETA	NOUN	acronym
SEV	PROPN	acronym
SEY	PROPN	acronym
Sf	NOUN	acronym
Sfr	NOUN	acronym
SFS	PROPN	acronym
SGD	NOUN	acronym
SGML	NOUN	acronym
SGN	PROPN	acronym
sh.	NOUN	abbreviation
SHH	PROPN	acronym
SHO	NOUN	acronym
SHP	NOUN	acronym
S.H.T.	NOUN	abbreviation
SI	NOUN	acronym
SI$	NOUN	acronym
sia	NOUN	acronym
SibA	NOUN	acronym
sid.	NOUN	abbreviation
siht.	NOUN	abbreviation
sit.	NOUN	abbreviation
SIT	NOUN	acronym
SITRA	PROPN	acronym
Sk	NOUN	acronym
SKAL	PROPN	acronym
SKDL	PROPN	acronym
SKK	NOUN	acronym
SKL	PROPN	acronym
SKOP	PROPN	acronym
Skp	NOUN	acronym
SKP	PROPN	acronym
SKr	NOUN	acronym
SKS	PROPN	acronym
SKV	PROPN	acronym
sl.	NOUN	abbreviation
SLA	NOUN	acronym
SLL	PROPN	acronym
SLS	PROPN	acronym
SLSY	PROPN	acronym
SLU	PROPN	acronym
SM	NOUN	acronym
SMP	PROPN	acronym
SMRT	PROPN	acronym
SMS	NOUN	acronym
snro	NOUN	abbreviation
SNS	PROPN	acronym
snt	NOUN	acronym
SNT	NOUN	acronym
SNTL	PROPN	acronym
so	ADV	acronym
so.	NOUN	abbreviation
SOA	PROPN	acronym
SOAP	NOUN	acronym
SOK	NOUN	acronym
SOOL	PROPN	acronym
sora-r	NOUN	acronym
sos.	NOUN	abbreviation
SOS	NOUN	acronym
sos.dem.	NOUN	abbreviation
sot.	NOUN	abbreviation
sotat.	NOUN	abbreviation
SOTE	NOUN	acronym
sov.	NOUN	abbreviation
sp.	NOUN	abbreviation
SP	PROPN	acronym
S&P	NOUN	acronym
SPAL	PROPN	acronym
SPR	PROPN	acronym
SQL	NOUN	acronym
sr	NOUN	acronym
sr.	NOUN	abbreviation
SR	NOUN	acronym
SRD	NOUN	acronym
SRG	NOUN	acronym
srk	NOUN	acronym
srk.	NOUN	abbreviation
SRl	NOUN	acronym
SRMY	PROPN	acronym
srnro	NOUN	abbreviation
SRV	PROPN	acronym
SSA	NOUN	acronym
SSKH	PROPN	acronym
SSP	PROPN	acronym
SSSR	PROPN	acronym
st.	NOUN	abbreviation
ST	NOUN	acronym
Stakes	PROPN	acronym
START	NOUN	acronym
std	NOUN	acronym
STD	NOUN	acronym
STHL	PROPN	acronym
STK	PROPN	acronym
stm.	NOUN	abbreviation
STM	NOUN	acronym
STS	PROPN	acronym
STT	NOUN	acronym
STTK	PROPN	acronym
STTV	PROPN	acronym
STUK	PROPN	acronym
STX	PROPN	acronym
su	ADV	abbreviation
SUB	PROPN	acronym
SubTV	PROPN	acronym
SUKOL	PROPN	acronym
SUL	PROPN	acronym
sunn.	NOUN	abbreviation
suom.	NOUN	abbreviation
SuomiTV	PROPN	acronym
SUPO	NOUN	acronym
SUR	NOUN	acronym
SUVA	NOUN	acronym
sv	NOUN	acronym
s.v.	NOUN	abbreviation
Sv	NOUN	acronym
SV	NOUN	acronym
SVAL	PROPN	acronym
SVC	NOUN	acronym
svh.	NOUN	abbreviation
SVL	NOUN	acronym
SVT	PROPN	acronym
SVUL	PROPN	acronym
SVVK	PROPN	acronym
SWE	PROPN	acronym
SwF	NOUN	acronym
SYKE	PROPN	acronym
SYL	PROPN	acronym
synt.	NOUN	abbreviation
SYP	PROPN	acronym
SYTY	PROPN	acronym
SZL	NOUN	acronym
t	NOUN	acronym
t.	NOUN	abbreviation
T	NOUN	acronym
T$	NOUN	acronym
TA	NOUN	acronym
T/A	NOUN	acronym
TAE	NOUN	acronym
TaEL	NOUN	acronym
tait.	NOUN	abbreviation
TaK	NOUN	acronym
TaL	NOUN	acronym
tal.hoit.	NOUN	abbreviation
TALK	NOUN	acronym
taloust.	NOUN	abbreviation
TaM	NOUN	acronym
TANE	PROPN	acronym
tanssit.	NOUN	abbreviation
TAO	NOUN	acronym
TAP	PROPN	acronym
TAPRI	PROPN	acronym
tark.	NOUN	abbreviation
TASKU	PROPN	acronym
TaT	NOUN	acronym
TaY	PROPN	acronym
TAYS	PROPN	acronym
tb.	NOUN	abbreviation
TB	NOUN	acronym
TBq	NOUN	acronym
TBWA	PROPN	acronym
TC	NOUN	acronym
T°C	NOUN	acronym
Tcd	NOUN	acronym
TCL	PROPN	acronym
TCP	NOUN	acronym
TCP/IP	NOUN	acronym
TDC	PROPN	acronym
TDF	PROPN	acronym
TE	NOUN	acronym
TeaK	PROPN	acronym
TEAM	PROPN	acronym
teatt.	NOUN	abbreviation
TeK	NOUN	acronym
TEK	PROPN	acronym
TEKEL	PROPN	acronym
tekn.	NOUN	abbreviation
TeL	NOUN	acronym
TEL	NOUN	acronym
TELA	PROPN	acronym
Tele2	PROPN	acronym
TeM	NOUN	acronym
TEM	PROPN	acronym
TEO	PROPN	acronym
teol.	NOUN	abbreviation
teoll.	NOUN	abbreviation
terveydenh.	NOUN	abbreviation
terveystiet.	NOUN	abbreviation
TES	NOUN	acronym
TeT	NOUN	acronym
TET	NOUN	acronym
TEVA	NOUN	acronym
TF	PROPN	acronym
Tg	NOUN	acronym
TGC-10	PROPN	acronym
TGK-5	PROPN	acronym
TGV	NOUN	acronym
TGy	NOUN	acronym
th.	NOUN	abbreviation
TH	PROPN	acronym
THB	NOUN	acronym
THL	PROPN	acronym
THz	NOUN	acronym
ti	ADV	abbreviation
TI	PROPN	acronym
TIF	NOUN	acronym
TIFF	NOUN	acronym
tiist.	NOUN	abbreviation
TIKE	PROPN	acronym
til.	NOUN	abbreviation
TIR	NOUN	acronym
TIVIT	PROPN	acronym
tj.	NOUN	abbreviation
TJR	NOUN	acronym
tjs	ADV	abbreviation
tjs.	NOUN	abbreviation
TJS	NOUN	acronym
tjsp	ADV	abbreviation
t&k	NOUN	acronym
tk.	NOUN	abbreviation
Tk	NOUN	acronym
TK	PROPN	acronym
Tkat	NOUN	acronym
TkK	NOUN	acronym
TKK	NOUN	acronym
TkL	NOUN	acronym
TKL	PROPN	acronym
Tkr	NOUN	acronym
TkT	NOUN	acronym
TKT	NOUN	acronym
Tku	PROPN	abbreviation
tl	NOUN	acronym
TL	NOUN	acronym
TLAB	PROPN	acronym
tlk	NOUN	acronym
tlk.	NOUN	abbreviation
Tlm	NOUN	acronym
Tlx	NOUN	acronym
tm.	NOUN	abbreviation
Tm	NOUN	acronym
TM	PROPN	acronym
TMA	PROPN	acronym
TMB	PROPN	acronym
tmi	ADV	abbreviation
tmk	NOUN	acronym
TMK	NOUN	acronym
TMM	NOUN	acronym
Tmol	NOUN	acronym
tms	ADV	abbreviation
tms.	NOUN	abbreviation
TMT	NOUN	acronym
tmv	ADV	abbreviation
tmv.	NOUN	abbreviation
tn	NOUN	acronym
TN	NOUN	acronym
TND	NOUN	acronym
TNK-BP	PROPN	acronym
to	ADV	abbreviation
TOAS	PROPN	acronym
toht.	NOUN	abbreviation
toim.	NOUN	abbreviation
toim.apul.	NOUN	abbreviation
toim.joht.	NOUN	abbreviation
toim.siht.	NOUN	abbreviation
TOKYO	PROPN	acronym
TOP	NOUN	acronym
TopK	PROPN	acronym
torst.	NOUN	abbreviation
tp.	NOUN	abbreviation
TPa	NOUN	acronym
TPE	NOUN	acronym
TPG	PROPN	acronym
TPK	PROPN	acronym
TPS	PROPN	acronym
Tre	PROPN	abbreviation
tri	NOUN	abbreviation
TRL	NOUN	acronym
TRY	NOUN	acronym
ts.	NOUN	abbreviation
Ts	NOUN	acronym
TS	PROPN	acronym
TSEMPPI	PROPN	acronym
TSK	PROPN	acronym
TSL	PROPN	acronym
Tsr	NOUN	acronym
tsto	NOUN	abbreviation
TSv	NOUN	acronym
TT	NOUN	acronym
TT$	NOUN	acronym
TTD	NOUN	acronym
TtK	NOUN	acronym
TTK	PROPN	acronym
TTKK	NOUN	acronym
TtL	NOUN	acronym
TTL	PROPN	acronym
TtM	NOUN	acronym
TTM	NOUN	acronym
TTS	NOUN	acronym
TtT	NOUN	acronym
TTT	NOUN	acronym
TTY	PROPN	acronym
TU	PROPN	acronym
Tug	NOUN	acronym
TUI	PROPN	acronym
TUKES	PROPN	acronym
TuKKK	PROPN	acronym
TUL	PROPN	acronym
TULE	NOUN	acronym
tuom.	NOUN	abbreviation
tus	NOUN	acronym
tv	NOUN	acronym
TV	NOUN	acronym
TV1	PROPN	acronym
TV2	PROPN	acronym
TVK	PROPN	acronym
TVO	PROPN	acronym
tvt	NOUN	acronym
TW	NOUN	acronym
TWb	NOUN	acronym
TWD	NOUN	acronym
ty	NOUN	acronym
TY	PROPN	acronym
TYK	PROPN	acronym
TYKS	PROPN	acronym
TYKY	NOUN	acronym
TYS	PROPN	acronym
TZS	NOUN	acronym
TΩ	NOUN	acronym
u	NOUN	acronym
U	NOUN	acronym
U2	PROPN	acronym
uä	NOUN	acronym
UAH	NOUN	acronym
UAK	NOUN	acronym
UAZ	PROPN	acronym
UBS	PROPN	acronym
UEF	PROPN	acronym
UFO	NOUN	acronym
UGS	NOUN	acronym
UGX	NOUN	acronym
UHT	NOUN	acronym
UIL	PROPN	acronym
UK	NOUN	acronym
ukg	NOUN	acronym
UKK	NOUN	acronym
ula	NOUN	acronym
ULI	PROPN	acronym
UM	NOUN	acronym
UMO	PROPN	acronym
umts	NOUN	acronym
UNCED	NOUN	acronym
UNCTAD	NOUN	acronym
UNDP	NOUN	acronym
UNEP	PROPN	acronym
UNESCO	PROPN	acronym
UNFPA	PROPN	acronym
UNHCR	PROPN	acronym
UNICEF	PROPN	acronym
UNIDO	PROPN	acronym
UNIFIL	PROPN	acronym
UNITAR	PROPN	acronym
UNU	PROPN	acronym
UNU-WIDER	PROPN	acronym
UPA	NOUN	acronym
UPI	PROPN	acronym
UPM	PROPN	acronym
ups.	NOUN	abbreviation
UPS	PROPN	acronym
UPU	PROPN	acronym
Ur$	NOUN	acronym
UrhoTV	PROPN	acronym
URHOtv	PROPN	acronym
urk.	NOUN	abbreviation
url	NOUN	acronym
URL	NOUN	acronym
us.	NOUN	abbreviation
US$	NOUN	acronym
USA	PROPN	acronym
USB	NOUN	acronym
USD	NOUN	acronym
USN	NOUN	acronym
USS	NOUN	acronym
UT	NOUN	acronym
UTi	PROPN	acronym
UTVA	NOUN	acronym
UudPr	PROPN	acronym
uv	NOUN	acronym
UVI	PROPN	acronym
UYI	NOUN	acronym
UYP	NOUN	acronym
UYU	NOUN	acronym
UZS	NOUN	acronym
v	NOUN	acronym
v.	NOUN	abbreviation
V	NOUN	acronym
va.	NOUN	abbreviation
VA	NOUN	acronym
vääp.	NOUN	abbreviation
VAG	PROPN	acronym
VAHO	PROPN	acronym
Vaiht.	NOUN	abbreviation
VAK	PROPN	acronym
VaKK	PROPN	acronym
VakO	NOUN	acronym
valt.	NOUN	abbreviation
valtiot.	NOUN	abbreviation
Valvira	PROPN	acronym
VAMP	PROPN	acronym
VankO	NOUN	acronym
vänr.	NOUN	abbreviation
var.	NOUN	abbreviation
varan.	NOUN	abbreviation
varat.	NOUN	abbreviation
vas.	NOUN	abbreviation
Vas.	NOUN	abbreviation
VASEK	PROPN	acronym
vast.	NOUN	abbreviation
VATT	PROPN	acronym
VAV	PROPN	acronym
VEB	NOUN	acronym
VEF	NOUN	acronym
VEL	NOUN	acronym
VELL	PROPN	acronym
VEO	PROPN	acronym
VES	NOUN	acronym
VET	PROPN	acronym
VG-62	PROPN	acronym
VGA	NOUN	acronym
VH	PROPN	acronym
VHF	NOUN	acronym
VHKK	PROPN	acronym
VHL	NOUN	acronym
vht	ADV	abbreviation
VHT	NOUN	acronym
VI	NOUN	acronym
vihr.	NOUN	abbreviation
Vihr.	NOUN	abbreviation
VIP	NOUN	acronym
virk.	NOUN	abbreviation
VJ	NOUN	acronym
vk	NOUN	acronym
vk.	NOUN	abbreviation
VK	PROPN	acronym
vkl	NOUN	acronym
VKL	PROPN	acronym
VKS	NOUN	acronym
VKSV	PROPN	acronym
VLP	PROPN	acronym
vm.	NOUN	abbreviation
VM	NOUN	acronym
VMP	PROPN	acronym
VN	NOUN	acronym
VND	NOUN	acronym
VNK	NOUN	acronym
VNN	NOUN	acronym
VNp.	NOUN	abbreviation
VO	NOUN	acronym
V.O.	NOUN	abbreviation
voim.op.	NOUN	abbreviation
VOO	PROPN	acronym
Vp.	NOUN	abbreviation
vpj	NOUN	acronym
vpj.	NOUN	abbreviation
vpk	NOUN	acronym
VPS	PROPN	acronym
VR	PROPN	acronym
vrk	NOUN	acronym
VRK	PROPN	acronym
vrt.	NOUN	abbreviation
vs	ADV	abbreviation
vs.	NOUN	abbreviation
vsk.	NOUN	abbreviation
VSO	PROPN	acronym
V.S.O.	NOUN	abbreviation
V.S.O.P.	NOUN	abbreviation
vt	NOUN	acronym
vt.	NOUN	abbreviation
VT	NOUN	acronym
VTB	PROPN	acronym
VTK	NOUN	acronym
VTL	NOUN	acronym
VTM	PROPN	acronym
VTML	PROPN	acronym
VTT	NOUN	acronym
VTV	PROPN	acronym
VTY	PROPN	acronym
VUV	NOUN	acronym
vv.	NOUN	abbreviation
VVO	PROPN	acronym
VVR	PROPN	acronym
VVV	PROPN	acronym
VW	NOUN	acronym
VY	PROPN	acronym
VYO	NOUN	acronym
w	NOUN	acronym
W	NOUN	acronym
WADA	PROPN	acronym
WAP	NOUN	acronym
Wb	NOUN	acronym
wc	NOUN	acronym
WC	NOUN	acronym
WCC	PROPN	acronym
WELMU	PROPN	acronym
WestLB	PROPN	acronym
WEU	PROPN	acronym
Wh	NOUN	acronym
WHO	PROPN	acronym
WIDER	PROPN	acronym
WiO	PROPN	acronym
WIPO	PROPN	acronym
WLAN	NOUN	acronym
WPP	PROPN	acronym
WRP	PROPN	acronym
Ws	NOUN	acronym
WSOY	PROPN	acronym
WST	NOUN	acronym
WTO	PROPN	acronym
WWF	PROPN	acronym
www	NOUN	acronym
WWW	NOUN	acronym
x	NOUN	acronym
X	NOUN	acronym
XAF	NOUN	acronym
XAG	NOUN	acronym
XAU	NOUN	acronym
XBA	NOUN	acronym
XBB	NOUN	acronym
XBC	NOUN	acronym
XBD	NOUN	acronym
XCD	NOUN	acronym
XDR	NOUN	acronym
XEU	NOUN	acronym
XFO	NOUN	acronym
XFU	NOUN	acronym
XL	NOUN	acronym
XML	NOUN	acronym
XOF	NOUN	acronym
XPD	NOUN	acronym
XPF	NOUN	acronym
XPT	NOUN	acronym
XRE	NOUN	acronym
XS	NOUN	acronym
XTS	NOUN	acronym
XXX	NOUN	acronym
y	NOUN	acronym
Y	NOUN	acronym
Y2K	NOUN	acronym
yA	NOUN	acronym
YA	NOUN	acronym
YAD	PROPN	acronym
yBq	NOUN	acronym
YBq	NOUN	acronym
yC	NOUN	acronym
y°C	NOUN	acronym
YC	NOUN	acronym
Y°C	NOUN	acronym
ycd	NOUN	acronym
Ycd	NOUN	acronym
YDD	NOUN	acronym
YEL	NOUN	acronym
YER	NOUN	acronym
ye.ups.	NOUN	abbreviation
yF	NOUN	acronym
YF	NOUN	acronym
yg	NOUN	acronym
Yg	NOUN	acronym
yGy	NOUN	acronym
YGy	NOUN	acronym
yH	NOUN	acronym
YH	NOUN	acronym
yhd.	NOUN	abbreviation
yht.	NOUN	abbreviation
yhteiskuntat.	NOUN	abbreviation
yHz	NOUN	acronym
YHz	NOUN	acronym
YIT	PROPN	acronym
yJ	NOUN	acronym
YJ	NOUN	acronym
yK	NOUN	acronym
YK	PROPN	acronym
ykat	NOUN	acronym
Ykat	NOUN	acronym
YKI	NOUN	acronym
yl.	NOUN	abbreviation
YL	PROPN	acronym
YLE	PROPN	acronym
ylik.	NOUN	abbreviation
ylil.	NOUN	abbreviation
ylim.	NOUN	abbreviation
ylimatr.	NOUN	abbreviation
yliop.	NOUN	abbreviation
yliopp.	NOUN	abbreviation
ylip.	NOUN	abbreviation
yliv.	NOUN	abbreviation
ylm	NOUN	acronym
Ylm	NOUN	acronym
ylx	NOUN	acronym
Ylx	NOUN	acronym
ym	ADV	acronym
ym.	NOUN	abbreviation
Ym	NOUN	acronym
YM	NOUN	acronym
YMCA	PROPN	acronym
ymol	NOUN	acronym
Ymol	NOUN	acronym
YMP	NOUN	acronym
yms	ADV	abbreviation
yms.	NOUN	abbreviation
yN	NOUN	acronym
YN	NOUN	acronym
yo	NOUN	acronym
yo.	NOUN	abbreviation
yo.merk.	NOUN	abbreviation
yp.	NOUN	abbreviation
yPa	NOUN	acronym
YPa	NOUN	acronym
YPF	PROPN	acronym
yrad	NOUN	acronym
Yrad	NOUN	acronym
YRl	NOUN	acronym
yrnro	NOUN	abbreviation
ys	NOUN	acronym
yS	NOUN	acronym
Ys	NOUN	acronym
YS	NOUN	acronym
ysr	NOUN	acronym
Ysr	NOUN	acronym
ySv	NOUN	acronym
YSv	NOUN	acronym
yt	NOUN	acronym
yT	NOUN	acronym
YT	NOUN	acronym
YTE	NOUN	acronym
YTJ	NOUN	acronym
YTK	NOUN	acronym
YTL	NOUN	acronym
YTM	NOUN	acronym
YTN	PROPN	acronym
YTT	NOUN	acronym
YTV	PROPN	acronym
YUD	NOUN	acronym
YUM	NOUN	acronym
YUN	NOUN	acronym
YUR	NOUN	acronym
YUTP	NOUN	acronym
yv.	NOUN	abbreviation
yV	NOUN	acronym
YV	NOUN	acronym
YVA	NOUN	acronym
yW	NOUN	acronym
YW	NOUN	acronym
yWb	NOUN	acronym
YWb	NOUN	acronym
YYA	NOUN	acronym
yΩ	NOUN	acronym
YΩ	NOUN	acronym
z	NOUN	acronym
Z	NOUN	acronym
Z$	NOUN	acronym
ž	NOUN	acronym
Ž	NOUN	acronym
zA	NOUN	acronym
ZA	NOUN	acronym
ZAL	NOUN	acronym
ZAR	NOUN	acronym
ZBD	PROPN	acronym
zBq	NOUN	acronym
ZBq	NOUN	acronym
zC	NOUN	acronym
z°C	NOUN	acronym
ZC	NOUN	acronym
Z°C	NOUN	acronym
zcd	NOUN	acronym
Zcd	NOUN	acronym
ZDF	PROPN	acronym
zF	NOUN	acronym
ZF	NOUN	acronym
zg	NOUN	acronym
Zg	NOUN	acronym
zGy	NOUN	acronym
ZGy	NOUN	acronym
zH	NOUN	acronym
ZH	NOUN	acronym
zHz	NOUN	acronym
ZHz	NOUN	acronym
zJ	NOUN	acronym
ZJ	NOUN	acronym
zK	NOUN	acronym
ZK	NOUN	acronym
zkat	NOUN	acronym
Zkat	NOUN	acronym
Zl	NOUN	acronym
zlm	NOUN	acronym
Zlm	NOUN	acronym
zlx	NOUN	acronym
Zlx	NOUN	acronym
zm	NOUN	acronym
Zm	NOUN	acronym
ZMK	NOUN	acronym
zmol	NOUN	acronym
Zmol	NOUN	acronym
ZMW	NOUN	acronym
zN	NOUN	acronym
ZN	NOUN	acronym
zPa	NOUN	acronym
ZPa	NOUN	acronym
zrad	NOUN	acronym
Zrad	NOUN	acronym
ZRN	NOUN	acronym
ZRZ	NOUN	acronym
zs	NOUN	acronym
zS	NOUN	acronym
Zs	NOUN	acronym
ZS	NOUN	acronym
zsr	NOUN	acronym
Zsr	NOUN	acronym
zSv	NOUN	acronym
ZSv	NOUN	acronym
zT	NOUN	acronym
ZT	NOUN	acronym
ZTE	PROPN	acronym
zV	NOUN	acronym
ZV	NOUN	acronym
zW	NOUN	acronym
ZW	NOUN	acronym
zWb	NOUN	acronym
ZWb	NOUN	acronym
ZWD	NOUN	acronym
ZWL	NOUN	acronym
ZWR	NOUN	acronym
zΩ	NOUN	acronym
ZΩ	NOUN	acronym
μA	NOUN	acronym
μBq	NOUN	acronym
μC	NOUN	acronym
μ°C	NOUN	acronym
μcd	NOUN	acronym
μF	NOUN	acronym
μg	NOUN	acronym
μGy	NOUN	acronym
μH	NOUN	acronym
μHz	NOUN	acronym
μJ	NOUN	acronym
μK	NOUN	acronym
μkat	NOUN	acronym
μlm	NOUN	acronym
μlx	NOUN	acronym
μm	NOUN	acronym
μmol	NOUN	acronym
μN	NOUN	acronym
μPa	NOUN	acronym
μrad	NOUN	acronym
μs	NOUN	acronym
μS	NOUN	acronym
μsr	NOUN	acronym
μSv	NOUN	acronym
μT	NOUN	acronym
μV	NOUN	acronym
μW	NOUN	acronym
μWb	NOUN	acronym
μΩ	NOUN	acronym
Ω	NOUN	acronym
